# 繁體中文 (Chinese - Traditional)

# Menu
User=用戶
Join...=註冊...
Login...=登錄...
Log in=登錄
Logout=退出登錄
Change password...=修改密碼...
User Preference = 個人偏好
System Settings... =系統設置...
System Settings = 系統設置
Crash =恢復備份數據...
Invite friends...=邀請好友...
Language=語言
Language Setting = 語言設置

Document Recovery = 文檔恢復
Your Preferences Information = 你的個人偏好信息
File=文件
New=新建
Project...=工程...
Schematic=原理圖
Schematic-Simulation=原理圖-仿真
Spice Symbol=仿真符號
Spice Subckt=Spice子電路
spicePre = 仿真編號
PCB=PCB
Schematic Module=原理圖模塊
PCB Module=PCB模塊
Save...=保存...
Save As...=另存為...
Save As Module...=另存為模塊...
Print=打印
Export Document=導出文檔
LTspice...=LTspice...
Eagle...=Eagle...
Altium...=Altium...
Cadence...=Cadence...
Pads...=Pads...
DXF=DXF
Import=導入


Edit=編輯
Undo=撤銷
Redo=重做
Cut=剪切
Copy=複製
Paste=粘貼
Select=選擇
Delete=刪除
Clear All = 清空畫布
Move=移動
Drag=拖移
Bring to Front=移到頂層
Send to Back=移到底層
Align=對齊
Align Left=左對齊
Align Right=右對齊
Align Top=頂對齊
Align Bottom=底對齊
Align Horizontal Centers=水平居中對齊
Align Vertical Centers=垂直居中對齊
Distribute Horizontally=水平等距分布
Distribute Vertically=垂直等距分布
Distribute Left Edges Equidistantly=左邊沿等距分布
Distribute Top Edges Equidistantly=上邊沿等距分布
Align Grid=對齊網格
Rotate=逆時針旋轉90度
Rotate Left=逆時針旋轉90度
Rotate Right=順時針旋轉90度
Flip Horizontal=水平翻轉
Flip Vertical=垂直翻轉
Rotate and Flip=旋轉與鏡像
Group/Ungroup Symbol...= 組合/解散符號

[menu_project]
View=查看
[/menu_project]
Find = 查找
Zoom In=放大
Zoom Out=縮小
Fit in Window=適合窗口
Refresh=刷新
Snap=吸附
Cross Cursor=十字光標
Toolbars=工具欄
Drawing Tools=繪圖工具
Wiring Tools=電氣工具
Power Objects=電源
PCB Tools = PCB工具
Footprint Tools = 封裝工具
Layers Tool = 層工具
Layer Manager = 層管理器
Enable and Show All Layers = 開啟和顯示全部圖層
Net Visible = 顯示網絡
Auto = 自動
Digital Objects=數字實體
Tools = 工具
Arc Center = 中心圓弧
Arc Type = 圓弧類型
Center Point Arc = 中心圓弧
Two-point Arc = 兩點圓弧

Place=放置
Drawing Tools=繪圖工具
Arc=圓弧
Elliptical Arc=橢圓弧
Ellipse=橢圓
Circle=圓
Pie=餅形
Line=線條
Polyline=折線
Rectangle=矩形
Rectangular = 矩形
The rectangle does not support non-90 degree rotation. Please use Solid Region instead. = 矩形不支持非 90 度角旋轉，請使用實心填充代替。

Rect=矩形
Round Rectangle=圓角矩形
Polygon=多邊形
Bezier=貝塞爾曲線
Path=路徑
Graphic=圖片
Bus=總線
Bus Entry=總線分支
Junction=節點
Net Port =網絡端口
Voltage Probe =電壓探針
Power Port=電源
Wire=導線
Annotation=文本注釋
Track=導線
Image=圖片
Arrow Head=箭頭
Arrowhead = 箭頭
Arrow=箭頭
No Connect Flag = 非連接標誌
Place=放置
Pin=管腳
Lock Selected Objects = 鎖定選中對象

Miscellaneous=雜項
Find Component=查找元件
Component = 元件
Footprint... = 封裝...
This component is deleted! = 這個元件已經被刪除！
Convert = 轉換
Convert Schematic to PCB = 原理圖轉PCB
The component ID will be reset according to the component prefix, this operation will clear Undo histories. Please notice: = 將根據元件編號重置元件ID，該操作將清空撤銷記錄。重置前請注意：
Please make sure the component prefixes of the schematic and PCB are corresponding = 請確保原理圖和 PCB 的元件編號相對應
Please reset the component ID of corresponding schematic or corresponding PCB too = 請把對應的原理圖或者PCB也進行重置操作
Do you want to continue? = 是否繼續？
Reset Component Unique ID = 重置元件唯一ID
Component ID reset successfully! = 元件ID重置成功！
Convert to PCB = 轉到PCB
Update PCB =更新PCB
Shortcut Keys Setting = 快捷鍵設置
Edit Symbol... = 修改符號...
Highlight Net... = 高亮網絡...
Simulate =仿真
Simulation =仿真
Standard Mode = 標準模式
Simulation Mode = 仿真模式
Change to Standard Mode = 切換至標準模式
Change to Simulation Mode = 切換至仿真模式
Welcome to Use JLCEDA = 歡迎使用嘉立創EDA
Welcome to Use EasyEDA = 歡迎使用EasyEDA
Enable Education Edition Features for Free >>> = 免費開啟教育版功能>>>
Quick Start = 快速開始
More Help = 更多幫助
Explore = 開源平台
Message = 消息
[start]
Example = 示例工程
Forum = 立創社區
Tutorials = 文檔教程
Videos = 視頻教程
[/start]
Custom Data = 自定義數據
JLCEDA = 嘉立創EDA

Copy Result Image = 複製圖形結果
Export Result Image = 導出圖形結果
Simulation Result = 仿真結果
Simulation Results... = 仿真結果...
Simulate this Sheet = 仿真當前頁
Simulate this Project = 仿真當前工程
Non-simulation mode, please switch to the simulation mode first and then run = 非仿真模式，請先切換至仿真模式再運行
Run the Document = 運行當前文檔
Run the Project... = 運行整個工程...
Netlist for Document = 生成本文件網絡
Netlist for Project = 生成本工程網絡
LTspice for This Sheet... = LTspice格式(當前頁)...
Spice for this Project... = 當前工程Spice網表...
Protel/Altium for PCB... = Protel/Altium格式...
PADS for PCB... = PADS格式...
FreePCB for PCB... = FreePCB格式...
Eagle for PCB... = Eagle 格式...F
Kicad for PCB... = Kicad 格式...
OrCAD for PCB... = OrCAD 格式...
BOM report... = 元器件清單...
BOM for Document... = 當前文檔清單...
BOM for Project... = 當前工程清單...
Pin Manager... = 引腳管理器...
Spice Model... = 仿真模型...
Layer Manager... =  層管理器...
Net Color... = 網絡顏色...
Design Rule... = 設計規則...
Copper Area = 鋪銅
Rebuild Selected = 重建所選
Rebuild All = 重建全部
Copper Area Manager... = 鋪銅管理器...
Export Pick and Place File = 導出坐標文件
Measure Distance = 測量距離
Set Canvas Origin by Mouse Location = 修改原點
Generates Pick and Place File = 生成貼片坐標文件
Unroute All = 清除布線
Auto Route = 自動布線
Export Autorouter File(DSN) = 導出自動布線文件(DSN)
Import Autorouter Session File(SES) = 導入自動布線會話(SES)
Autorouter File(DSN) = 自動布線文件(DSN)
Autorouter Session File(SES) = 自動布線會話(SES)
Terminate Routing Automatically = 自動結束布線
Delete Segments = 刪除線段
Unroute Connections = 刪除連接
Unroute Connection = 刪除連接
Unroute Nets = 刪除網絡
Select = 選擇
Segments = 線段
Connection = 連接
Net = 網絡
Apply Design Rule While Routing and Auto Placing Via = 布線切層時自動放置的過孔與導線應用設計規則

Add SubPart=添加子模塊
Annotate... = 標註編號...
Config=配置

Help=幫助
About=關於
Online Chat =
Shortcut Keys = 快捷鍵
FAQ = 常見問題
Tutorials = 使用教程
Basic Tutorials = 基礎教程
Video Tutorials = 視頻教程
Essential Check = 特別檢查
Simulation Tutorials = 仿真教程
Updated Instructions = 更新說明
Open File Format = 文件格式
About Upgrade = 關於升級
User Forum = 用戶論壇
Feature Request = 功能建議
Feature Requests = 功能建議
Bug Report = Bug 報告
Bug Reports = Bug 報告
Tips & Skill = 小技巧
Ask for Help = 尋求幫助
Schematic Capture = 原理圖
Spice Simulation = 仿真
Non-simulation mode = 非仿真模式
PCB Layout = PCB設計
General Discussion = 一般討論
More Information = 更多信息
Privacy Policy = 隱私政策
#Terms of Use & Privacy Policy = 使用條款與隱私
Terms of Service = 服務條款
Plans and Pricing = 價格政策
Help Translate = 幫助翻譯
About Us = 團隊介紹
Contact Us = 聯繫我們
Change History=更新日誌
Join Us = 誠聘英才
#PCB Fabrication Capabilities = PCB製造能力
PCB Fabrication = PCB製造
Order Capabilities = 工藝能力
Order Price = 價格計算
Order Essential Check = 特別檢查
Order FAQ = 常見問題
Order Process = 下單流程
Full Screen = 全屏

Support = 支持
[leftNavTabs]
Support = 技術支持
[/leftNavTabs]
Historical Records... = 歷史記錄...
Extensions = 擴展
Order PCB... = 訂購PCB...
Import Changes = 導入變更
Press {0}F11{1} to switch to full screen. = 按{0}F11{1}切換到全屏模式
Delete Selected = 刪除所選
Simulate... = 仿真...
Config = 配置
Terms of Service & Privacy Policy = 服務條款和隱私政策
Help Topics = 幫助
3D Model(obj) = 3D模型(obj)
3D Model(step) = 3D模型(step)
SVG Source... = SVG源碼...
File Source = 文件源碼
Group These Items as a Symbol = 組合這些圖形為一個符號
Group These Items as a Footprint = 組合這些圖形成為一個封裝
Set Canvas Origin = 畫布原點
Document Setting = 圖紙設置
Sheet Properties = 表格屬性
Set Board Outline = 邊框設置
Teardrop... = 淚滴...
Panelize... = 拼板...
Check Dimension = 尺寸檢查
Smart Dimension = 智能尺寸
Footprint Wizard = 封裝嚮導
Footprint Wizard... = 封裝嚮導...
Select package type = 選擇封裝類型
Smart Dimension Properties = 智能尺寸屬性
Global Delete = 全局刪除
Cross Probe = 交叉選擇
Cross Probe and Place = 布局傳遞
Paper Size = 紙張大小
Register = 註冊
User Center = 個人中心

By Mouse Location = 從光標位置
Set Coordinate = 設置坐標
By Coordinates... = 從輸入坐標...
By Center of Pads = 從焊盤中央
By Center Grid of Symbols = 從圖形中心格點

#Schematic Canvas Properties
Properties=屬性
Apply=應用
Save as default=存為默認值
Canvas Properties=畫布屬性
Width=寬
Height=高
Background=背景色
Visible Grid=網格可見
Grid Visible = 顯示網格
Real-Time Track Length = 顯示實時線長
Display Real-Time Track Length = 顯示實時線長
Grid Color=網格顏色
Grid Size=網格大小
Grid Style=網格樣式
Grid.Line Width = 網格線寬
Grid.Line Spacing = 網格間距
Copper to Board Outline = 到邊框間距
Improve Fabrication = 製造優化
Spoke Width = 發散線寬
Stroke Color=線條顏色
Stroke Width=線條寬度
Stroke Style=線條樣式
Fill Color=填充顏色
Selected Objects=選中數量
Frame Size = 外形尺寸
Alt Snap = ALT鍵柵格
Snap size when pressing the Alt key = 按下ALT鍵時的柵格尺寸
Prefix Start = 標註起始

#Text Properties
Text Properties =文本屬性
Text = 文本
Color = 顏色
Font Family = 字體
Font Size = 字體大小
Font Weight = 字體粗細
Font Style = 樣式
Text Type = 文本類型
Text Anchor = 文本錨點
Baseline = 基線
(Auto)=(自動)
(auto)=(自動)
start = 頭部
middle = 中間
end = 尾部
inherit = 繼承
comment = 注釋
spice = Spice仿真
normal = 正常
italic = 斜體
Default = 默認
Add = 新增
bold = 粗體
bolder = 更粗
lighter = 更細
Failed to parse the font file: {name} = 解析字體失敗: {name}
Please select a font file of ttf or woff format. = 請選擇一個格式為 ttf 或 woff 的字體文件
Add font success: {name} = 字體添加成功: {name}
Failed to add font: {name} = 字體添加失敗: {name}
Add Font = 添加字體
Failed to parse cached font: {name} = 加載緩存字體失敗: {name}
Load cached fonts fail! = 加載緩存字體失敗

#Stroke
Stroke Color = 顏色
Stroke Width = 線寬
Stroke Style = 樣式
Fill Color = 填充顏色
X Radius = X 半徑
Y Radius = Y 半徑

#spice
Switch mode = 切換模式
The current documents will be closed, and reopen after switching mode, do you want to continue? = 將關閉當前文檔，切換模式後重新打開，是否繼續？
PCB related documents are not allowed in emulation mode = 仿真模式下不允許打開PCB相關文檔
Please change the editor to "Simulation" mode first at the top left corner. = 請先點擊左上角切換編輯器至「仿真」模式
Please change the editor to "Standard" mode first at the top left corner. = 請先點擊編輯器左上角切換至「標準」模式
Common = 通用器件
spice.open = 斷開
spice.close = 閉合
Sources = 電源
Instruments/Meters = 儀器 儀表
Transistors = 晶體管
Digital Circuits = 數字電路
Operational Amplifier = 運算放大器
multimeter = 萬用表
multimeter Settings = 萬用表設置
FunctionGenerator Settings = 函數發生器設置
Voltage Source Settings = 電壓源設置
Current Source Settings = 電流源設置
Powersw Settings = 電流開關設置
Resistor Settings = 電阻設置
Capacitor Settings = 電容設置
Diode Settings = 二極管設置
voltPowersw Settings = 電壓控制開關設置
Inductor Settings = 電感設置
VCVS Settings = 電壓控制電壓源設置
CCCS Settings = 電流控制電流源設置
VCCS Settings = 電壓控制電流源設置
CCVS Settings = 電流控制電壓源設置
JFET Settings = 結形場效應管設置
FET Settings = 場效應管設置
Transmission Line Settings = 傳輸線設置
Oscilloscope Settings = 示波器設置
XFMR Settings = 變壓器設置
LOGIC Settings = 邏輯器件設置
LOGICSTATE Settings = 邏輯門設置
DIGITALCLOCK Settings = 數字鐘設置
Potentiometer Settings = 滑動變阻器設置
MUTUAL_INDUCTORS Settings = 變壓器設置
NE555 Settings = NE555 設置
THREE_PHASE Settings = 三相交流電源設置
Logic_Probe Settings = 邏輯探針設置
78XX Settings = 78XX 設置
79XX Settings = 79XX 設置
OPAMP5PEE Settings = 5端放大運算器設置
OPAMP5PEECN Settings = 5端放大運算器設置
OPAMP3PEE Settings = 3端放大運算器設置
OPAMP3PEECN Settings = 3端放大運算器設置
DELAY_FUSE Settings = 延時保險絲設置
Ratio = 變比
K[%] = 比例因子[%]
Model = 模型
States = 電平
Voltage[V] = 電壓[V]
Voltage gain[V/V] = 電壓增益[V/V]
Current gain[A/A] = 電流增益[A/A]
Transconductance[Mho] = 跨導[Mho]
Transresistance[Ω] = 互阻[Ω]
Voltage Source Type = 電壓源類型
Current Source Type = 電流源類型
multimeter type = 萬用表類型
power type = 電源類型
Voltmeter Resistance(R)(Ω) = 伏特計電阻(R)(Ω)
Amperometer Resistance(R)(Ω) = 安培計電阻(R)(Ω)
mu.V = 伏特計
mu.A = 安培計
Sine Wave = 正弦波
Triangular Wave = 三角波
Rectangular Wave = 矩形波
AC = 交流
DC = 直流源
SINE = 正弦源
PULSE = 脈衝源
EXP = 指數源
SFFM = 單頻調頻源
PWL = 分段線性源
B.spice = 行為源
DC Value[V] = 直流值[V]
DC Value[A] = 直流值[A]
DC offset[V] = 直流偏移[V]
DC offset[A] = 直流偏移[A]
Amplitude[V] = 振幅[V]
Amplitude[A] = 振幅[A]
Freq[Hz] = 頻率[Hz]
Theta[1/s] = 阻尼因子[1/s]
Tdelay[s] = 延時[s]
Phi[deg] = 相位[deg]
Tperiod[s] = 脈衝周期[s]
Ton[s] = 脈衝寬度[s]
Tfall[s] = 下降時間[s]
Trise[s] = 上升時間[s]
Von[V] = 脈動值[V]
Von[A] = 脈動值[A]
Vinitial[V] = 初始值[V]
Vinitial[A] = 初始值[A]
Vpulsed[V] = 峰值[V]
Vpulsed[A] = 峰值[A]
Rise Delay[s] = 上升延遲[s]
Rise Tau[s] = 上升時間常數[s]
Fall Delay[s] = 下降延遲[s]
Fall Tau[s] = 下降時間常數[s]
Carrier Freq[Hz] = 載波頻率[Hz]
Modulation Index = 調製指數
Signal Freq[Hz] = 信號頻率[Hz]
Time[s] = 時間[s]
Value[V] = 值[V]
Value[A] = 值[A]
Waveforms = 波形
Duty cycle[%] = 占空比[%]
Amplitude[Vp] = 振幅[Vp]
Offset[V] = 偏置[V]
Rise/Fall Time[sec] = 上升/下降時間[sec]
Capacitance[F] = 容值[F]
sComponent = 模型
Inductance[H] = 電感[H]
Gbw = 增益帶寬積
Slewrate = 擺率
Avol = 開環增益
Rout(Ω) = 輸出電阻
Rin(Ω) = 輸入電阻
Ibias[A] = 輸入偏置電流[A]
Inhi[V] =  共模輸入電壓(Vp)
Inlo[V] =  共模輸入電壓(Vn)
Isc[A] = 短路輸出電流[A]
Outhi[V] = 空載輸出電壓差(Vp)
Outlo[V] = 空載輸出電壓差(Vn)
Vabsmax[V] = 電壓最大壓差[V]
Vmin[V] = 最小供電電壓[V]
Iq[A] = 靜態電流[A]
Cin[F] = 輸入電容[F]
high = 高
low = 低
Oscilloscope = 雙通道示波器
Logic Analyzer = 邏輯分析儀
Channel_A = 通道_A
Channel_B = 通道_B
Channel A = 通道 A
Channel B = 通道 B
Time = 時間
Reverse = 反向
Simulation file exceed = 仿真文件過大
The simulation file is too large and has been stopped for performance reasons. = 仿真文件過大，出於性能原因已停止。
Timebase = 時基
Scale: = 刻度：
X pos.(Div): = X 軸位移(格)：
Y pos.(Div): = Y 軸位移(格)：
View meter... = 查看儀表...
The circuit has components without simulation model: = 該電路存在沒有仿真模型的元器件：
Your simulation interval is too short to simulate, please wait 5 seconds later and try again; if still show this message, may be you simulated over 500 times the maximum simulation times per day. = 您兩次仿真的時間間隔過短，請等待 5 秒後再次嘗試；如果仍然提示該信息，可能你已經超過每天 500 次的仿真次數限制。
Resistor1_US = 電阻器1_美標
Resistor1_EU/IEC = 電阻器1_歐標
Resistor1_3D = 電阻器1_3D
Capacitor1_US = 電容器_美標
Capacitor1_EU/IEC = 電容器_歐標
Capacitor1_3D = 電容器_3D
Rheostat_US = 變阻器_美標
Rheostat_EU/IEC = 變阻器_歐標
Rheostat_3D = 變阻器_3D
Capacitor_Electrolytic_US = 電解電容器_美標
Capacitor_Electrolytic_EU/IEC = 電解電容器_歐標
Capacitor_Electrolytic_3D = 電解電容器_3D
Inductor_US = 電感器_美標
Inductor_EU/IEC = 電感器_歐標
Inductor_3D = 電感器_3D
Resistor2_US = 電阻器2_美標
Resistor2_EU/IEC = 電阻器2_歐標
Resistor2_3D = 電阻器2_3D
Multimeter = 萬用表
Multimeter_3D  = 萬用表_3D
Oscilloscope = 示波器
Oscilloscope_3D  = 示波器_3D
Signal_Generator = 函數發生器
Signal Generator_3D  = 函數發生器_3D
Wattmeter = 瓦特計
Wattmeter_3D = 瓦特計_3D
NSSWS1080T_3D = 發光二極管_3D
Voltage_Source_VDC = 電壓源_直流源(DC)
Voltage_Source_VSin = 電壓源_正弦源(SINE)
Voltage_Source_VPULSE = 電壓源_脈衝源(PULSE)
Voltage_Source_VEXP = 電壓源_指數源(EXP)
Voltage_Source_VSFFM = 電壓源_單頻調頻源(SFFM)
Voltage_Source_VPWL = 電壓源_分段線性源(PWL)
Voltage_Source_V_Behavioral_Source = 電壓源_行為源(B)
Current_Source_IDC = 電流源_直流源(DC)
Current_Source_ISin = 電流源_正弦源(SINE)
Current_Source_IPULSE = 電流源_脈衝源(PULSE)
Current_Source_IEXP = 電流源_指數源(EXP)
Current_Source_ISFFM = 電流源_單頻調頻源(SFFM)
Current_Source_IPWL = 電流源_分段線性源(PWL)
Current_Source_I_Behavioral_Source = 電流源_行為源(B)
CCCS_1 = 電流控制電流源_1
CCCS_2 = 電流控制電流源_2
CCVS_1 = 電流控制電壓源_1
CCVS_2 = 電流控制電壓源_2
VCCS = 電壓控制電流源
VCVS = 電壓控制電壓源
Three_Phase_Wye_Load = 三相電源Y型
Three_Phase_Delta_Load = 三相電源三角型
78XX = 78系列穩壓器
79XX = 79系列穩壓器
555 = 555定時器
555_3D = 555定時器_3D
Transformer_US = 變壓器_美標
Transformer_EU/IEC = 變壓器_歐標
Transformer_Center_Tapped_US = 中心抽頭變壓器_美標
Transformer_Center_Tapped_EU/IEC = 中心抽頭變壓器_歐標
Mutual_Inductor_US = 互感器1_美標
Mutual_Inductor_EU/IEC = 互感器1_歐標
Mutual_Inductor2_US = 互感器2_美標
Mutual_Inductor2_EU/IEC = 互感器2_歐標
OR2EE_US = 2輸入或門_美標
OR3EE_US = 3輸入或門_美標
OR4EE_US = 4輸入或門_美標
OR2EE_CN = 2輸入或門_國標
OR3EE_CN = 3輸入或門_國標
OR4EE_CN = 4輸入或門_國標
NOR2EE_US = 2輸入或非門_美標
NOR3EE_US = 3輸入或非門_美標
NOR4EE_US = 4輸入或非門_美標
NOR2EE_CN = 2輸入或非門_國標
NOR3EE_CN = 3輸入或非門_國標
NOR4EE_CN = 4輸入或非門_國標
AND2EE_US = 2輸入與門_美標
AND3EE_US = 3輸入與門_美標
AND4EE_US = 4輸入與門_美標
AND2EE_CN = 2輸入與門_國標
AND3EE_CN = 3輸入與門_國標
AND4EE_CN = 4輸入與門_國標
NAND2EE_US = 2輸入與非門_美標
NAND3EE_US = 3輸入與非門_美標
NAND4EE_US = 4輸入與非門_美標
NAND2EE_CN = 2輸入與非門_國標
NAND3EE_CN = 3輸入與非門_國標
NAND4EE_CN = 4輸入與非門_國標
XOR2EE_US = 異或門_美標
XOR2EE_CN = 異或門_國標
XNOR2EE_US = 同或門_美標
XNOR2EE_CN = 同或門_國標
Digital_Clock_1Hz = 數字鐘
Logicstate_0 = 邏輯狀態_0
Logicstate_1 = 邏輯狀態_1
Logic_Probe = 邏輯探針
Buffee = 驅動門
INVEE_US = 取反指令_美標
INVEE_CN = 取反指令_國標
Schmittbuffee = 施密特驅動門
LM358N_US = LM358N_美標
LM358N_CN = LM358N_國標
OPAMP3PEE_US = 3端運算放大器_美標
OPAMP3PEE_CN = 3端入運算放大器_國標
OPAMP5PEE_US = 5端入運算放大器_美標
OPAMP5PEE_CN = 5端入運算放大器_國標
Voltage_Controlled_Switch = 電壓控制開關
Current_Controlled_Switch = 電流控制開關
FUSE = 熔斷器
Delay_Fuse = 延時熔斷器
Transmission_Line = 傳輸線
Crystal = 晶體
DFFEE = D觸發器
TFFEE = T觸發器
JKFFEE = JK觸發器
SRFFEE = SR觸發器
SRLATCHEE = SR鎖存器
SRNANDFFEE = 與非型基本SR觸發器
SRNORFFEE = 或非型基本SR觸發器
INVTSEE = 施密特反相器
INVODEE = 集電極開路反相器
Cbuffer = 緩衝器
SPDT_Open = 單刀雙擲（斷開）
SPDT_Close = 單刀雙擲（閉合）
SPST_Close = 單刀單擲（閉合）
SPST_Open = 單刀單擲（斷開）
Fast_Crystal = 快速晶振
Lamp = 燈泡
BCD_Segment = 數碼管
Seven_Segment = 七段數碼管
Traffic_Light = 交通燈
Lamp Settings = 燈泡設置
Power[W] = 功率[W]
Dropout Voltage[V] = 壓差[V]
Current[A] = 電流[A]
Threshold[V] = 閾值電壓[V]
Clock Rate = 時鐘頻率
TrafficLight Settings = 交通燈設置
BCDSegment Settings = 數碼管設置
SevenSegment Settings = 七段數碼管設置
SPDT Settings = 單刀雙擲開關設置
SPST Settings = 單刀單擲開關設置
LogicAnalyzer Settings = 邏輯分析儀設置
Fuse Settings = 熔斷器設置
Wattmeter Settings = 瓦特計設置
open = 打開
close = 關閉
Common Anode = 共陽
Common Cathode = 共陰
AC Amplitude = AC幅度
AC Phase = AC相位
There are some parts haven't spice model, please use "EElib" and "Spice Symbol" at "Libraries" of "Simulation" mode, or you can assign the spice model for them: = 存在沒有仿真模型的元器件，請優先使用仿真模式下的「基礎庫」和元件庫中的「仿真符號」進行仿真，或指定仿真模型：

#Pin
Pin Properties = 引腳屬性
Orientation = 方向
Line 45° = 線條45°
Line 90° = 線條90°
Arc 45° = 圓弧45°
Arc 90° = 圓弧90°
Free Angle = 自由角度
Start X = 起點X
Start Y = 起點Y
Length = 長度
Name = 名稱
name = 名稱
Number = 編號
Spice Pin Order = spice管腳編號
Display Number = 顯示編號
Clock = 時鐘
Show = 顯示引腳
Electric = 電氣特性

#Junction
Junction Properties = 節點屬性
X Location = X坐標
Y Location = Y坐標
Size = 大小
Color = 顏色

#Net Label
Net Label = 網絡標籤

#Part
Prefix = 編號

#Image Properties and Dialog
Add Image = 添加圖片
Image Properties = 圖片屬性
Image URL = 圖片網址
Input an image URL = 請輸入圖片網址
Invalid image URL = 無效的圖片網址
Invalid Prefix = 無效的編號
Failed to load the image = 圖片加載失敗
Image URL contains special characters = 圖片網址包含特殊字符
From Web URL = 圖片網址
From Local Computer = 從本地計算機
Please select a png/gif/jpg file. = 請選擇一個png/gif/jpg文件
Please select an image file. = 請選擇一個圖片文件
Select an image file = 選擇一個圖片文件
Insert Image to PCB = 插入圖片到PCB
Tolerance = 容差
tolerance = 容差
capacitance = 容量
frequency = 頻率
Rated Voltage = 額定電壓
Rated Current = 額定電流
resistance = 阻值
Resistance = 阻值
Resistance[Ω] = 阻值[Ω]
inductance = 電感係數
Operating Temperature = 工作溫度
Shape Invert = 圖形反轉
Image Size = 圖片尺寸
Color Tolerance = 顏色容差
Simplify Level = 簡化水平
Corner Threshold = 平滑尖角
Despeckle Size =

#PCB Canvas Properties
Units = 單位
Snap Size = 柵格尺寸
Other = 其它
Routing Width = 線寬
[router]
Routing Width = 布線寬度
[/router]
Please using hotkey {0}{key1}{1} or {2}{key2}{3} to change track width while on routing. = 在布線過程中，請使用快捷鍵 {0}{key1}{1} 或者 {2}{key2}{3} 修改線寬。
Routing Angle = 拐角
Routing Conflict = 布線衝突
Remove Loop = 移除迴路
Cut SilkScreen = 裁剪絲印
Grid = 網格
Grid 90 = 網格90
Grid 45 = 網格45
Copper Zone = 鋪銅區
Visible = 可見
Invisible = 不可見
Ignore = 忽略
Block = 阻擋
RoundTrack = 環繞

#Track
Track Properties = 導線屬性
Layer = 層
Net = 網絡
Start X = 起點X
Start Y = 起點Y
End X = 終點X
End Y = 終點Y
ID= ID

#Pad Properties
Pad Properties = 焊盤屬性
Shape = 形狀
Hole(D) = 孔直徑
Center X = 中心X
Center Y = 中心Y
Round = 圓形
Oval = 長圓形
Hole Shape = 孔形狀
Slot = 槽形
Hole(Length) = 孔長度
Plated = 金屬化
None = 否
Paste Mask Expansion = 助焊擴展
Solder Mask Expansion = 阻焊擴展

#Via Properties
Via Properties = 過孔屬性
Diameter = 直徑
Drill Diameter = 過孔內徑

#Hole Properties
Hole Properties = 孔屬性


#TEXT
Text Properties = 文本屬性
Line Width = 線寬
Rotation = 旋轉角度
Fonts Management = 字體管理

#Dimension Properties
Dimension Properties = 尺寸屬性

#Footprint Properties
Component Properties = 元件屬性
Display Prefix = 顯示編號
Pin Name = 引腳名稱
Pin Number = 引腳編號
Spice Pin Number = 仿真引腳編號
Graphics = 圖形
Pattern = 形狀

Pin: =
Netflag: =
Netlabel: =
NetPort: =
Voltage Probe: =
Pin: =
Hidden Pin: =
Unknown: =

#Arc Properties
Arc Properties = 圓弧屬性
Start Angle = 起始角度
End Angle = 結束角度
Rotation Direction = 旋轉方向

#Rect Properties
Rect Properties = 矩形屬性
Round radius = 圓角半徑

#Circle Properties
Circle Properties = 圓屬性
Radius = 半徑

#CopperArea Properties
CopperArea Properties = 鋪銅屬性
Clearance = 間距
Pad Connection = 焊盤連接
Direct = 直接
Spoke = 輪輻狀
Keep Island = 保留孤島
Fill Style = 填充樣式
CopperArea conflict: copper area outlines in same layer with different net names must not overlap = 鋪銅區衝突: 同一層的不同鋪銅區邊界不能重疊
Copper area rebuild complete! You can set "Copper Zone" as "Visible" at the right-hand property panel after single click the empty area. = 鋪銅完成！單擊空白區後在右邊屬性面板可以設置「鋪銅區」為「可見」。
Please create board outline first. = 請先創建電路板邊界
Board outlines are not closed. = 電路板邊界沒有閉合
Rebuild CopperArea = 重建鋪銅區
Edit Points= 編輯點
Direct = 直連
Spoke = 發散
No Solid = 無填充
Board Cutout = 槽孔
Solid = 全填充
[copperArea]
None = 無填充
[/copperArea]

#Custom Properties
Custom Properties = 自定義屬性
Fixed Properties = 固定屬性
Add new parameter = 增加參數
Add New Parameter = 增加參數
Add New Supplier = 增加供應商
Mounted = 上件
Unknown = 未知

Custom = 自定義
Scan the QR code below and open it on the mobile side = 掃描下方二維碼，在移動端打開
How to create a single layer PCB = 如何繪製單層板
Currently doesn't support layout single layer directly, please refer at: = 暫不支持直接繪製單層板，單層板的繪製方法請查看：

#Dialog Register
Create an account = 創建賬號
Username = 用戶名
Password = 密碼
Confirm Password = 確認密碼
Email = 電子郵件
Please read this before you register = 註冊前建議閱讀
Hi {username} = 你好，{username}

#Dialog lostPassword
Lost Password... = 丟失密碼...
Find the password using your email = 通過郵件找回密碼



#Dialog Login
Login = 登錄
Username or Email = 用戶名或郵件
Remember Me = 記住我
Third party = 第三方
Login and Register = 登錄與註冊
Your login information seems expired, please login again. Don't need to close the opening files, you can continue to save them after login. = 你的登錄信息好像已經失效，請重新登錄。已打開的文檔不需要關閉，登錄後可繼續保存。

#Dialog Reset Password
Reset a password using your email = 輸入你註冊的email,重置密碼
Your registered email = 註冊郵件

#Dialog Reaction
Re-send an activation code to your email  = 重發郵件激活碼

#Dialog Invite
Invite friends to register = 邀請朋友註冊
Your friend's email = 朋友郵件

#Dialog Add A New Parameter
Add a new parameter = 添加自定義參數
Key = 名稱
Value.new_para = 參數
In BOM = 添加在BOM中
Add into BOM = 加入BOM
Invalid key = 不合法的名稱
This field is required. = 該輸入框必填。

#Dialog Change Your Password
Change your password = 修改密碼
Old password = 舊密碼
New Password = 新密碼
Confirm Password =確認密碼

#Dialog Create New Design
Save as a New Project = 另存為新工程
Save as a schematic = 保存為原理圖
Save as Symbol = 保存為符號
Save as a spice Symbol = 保存為仿真符號
Save as a spice subckt = 保存為Spice子電路
YOU MUST CREATE A SPICE SYMBOL WITH EXACTLY THE SAME NAME AS THIS SUBCKT = 注意你必須創建一個與之同名的仿真符號
Save as a PCB file  = 保存為PCB文件
Save as Footprint = 保存為封裝
Save as a Schematic Module = 保存為原理圖模塊
Save as a PCB Module = 保存為PCB模塊
Save as 3D Model = 保存為3D模型
Save as a WaveForm = 保存為波形
Do not allow saving to target project =
Title = 標題
Share = 分享
Add file = 添加文件
Visibility = 可見性
Allow Comments = 允許評論
Public (Anyone can see this project but only you can modify it.) = 公開 (只有你能修改該工程，所有人都可以看到它)
Private (Only you can see and modify this project) = 私有(只能你能看到並修改它)
Create new project success! = 新建工程成功
You can now create files under this project = 現在可以在工程下創建文檔了
This file must be saved under a project, choose other project or create a new project = 該文件必須保存在工程下，請選擇或新建一個工程。
Please login to save this kind of document = 請登錄後保存該文檔
Duplicated project title = 工程標題已存在
#Duplicated document title = 文件標題已存在
Project does not exist = 工程不存在
Document does not exist = 文件不存在
document not exists = 文件不存在

Categories = 目錄
Project = 工程
Short description = 簡短描述
Content = 內容
Modify this project info. = 修改該工程信息
Modify this file info. = 修改該文檔信息
Notice = 注意
Search for it before creating a new one.= 創建前先嘗試查詢一下
Manufacturer Part Number = 製造商元器件編號
Supplier = 供應商
Or = 或
Supplier Part = 供應商編號
Supplier Part Number = 供應商料號
Link = 鏈接
link = 鏈接
The professional function please refer at: = 高級功能請查閱：

#Dialog Clone My Part
#Clone it to a project = 克隆它到你自己的工程中
#Clone it, then edit it = 克隆它,然後你就可以重新修改它
Clone your file = 克隆文件

#Dialog Subckt
Attach a Subckt to this spice symbol = 為該器件添加仿真模型數據
Subckt string  = 模型數據
Spice symbol title just allow [0-9][a-z][A-Z] and _ = 仿真符號的標題只允許數字，字母和下劃線！

#Design Manager
Design Manager = 設計管理器
Nets = 網絡
DRC Errors = DRC錯誤
Are you sure you want to unroute this net? = 確定要清除該網絡的布線嗎？
Unroute = 清除布線
Track Length = 線長
Via/Hole Outer Size = 孔外徑
Filter nets = 篩選網絡
Design Rule Checking = 設計規則檢查
Board Outline = 邊框
Plane Zone = 內電層
[drcRule]
Width = 寬
DRC Width = DRC寬
Length = 線長
DRC Length = DRC線長
Drill Diameter = 孔內徑
DRC Drill Diameter = DRC孔內徑
Diameter = 孔外徑
DRC Diameter = DRC孔外徑
Object = 元素
DRC Clearance = DRC間距
[/drcRule]
#It will take a while to unroute this net, do you want to continue? = 清除布線可能要多花一些時間，確定要繼續嗎？
More than one netlabel is found in wire, please checked whether this is correct, if you design it on purpose, please ignore this warning. = 該導線存在多個網絡標籤，請注意是否正常，若是設計需要，可忽略當前警告。
Incomplete net, a complete net should contain two or more pins, if you design it on purpose, please ignore this warning. = 該網絡連接不完整，完整的網絡需要連接兩個及以上引腳，若是設計需要，可忽略當前警告。
This netlabel is not connected with any pin. = 該網絡標籤未與任何引腳連接。
Incomplete connection, please check. = 該網絡連接不完整，請檢查。
The clearance between two objects is less than the Design Rule Checking (DRC) clearance which has different nets. = 這兩個不同網絡的元素間距小於設計規則(DRC)的間距
The diameter is less than Design Rule Checking (DRC) diameter = 孔外徑小於設計規則(DRC)的孔外徑
The drill diameter is less than Design Rule Checking (DRC) drill diameter = 孔內徑小於設計規則(DRC)的孔內徑
The track length is longer than Design Rule Checking (DRC) track length = 導線總長度大於設計規則(DRC)的線長
The track width is less than Design Rule Checking (DRC) track width = 導線寬度不能小於設計規則(DRC)的線寬

#Dialog Simulation
Show your simulation report = 顯示仿真報告
Download netlist = 下載網絡表
Run = 運行
Components = 元件

#Dialog Import
Import file from your computer = 從你的電腦導入文件
Maximum file size: 30 MB = 最大文件尺寸: 30MB
Maximum file size: 100 MB = 最大文件尺寸: 100MB
Chose file  = 選擇文件
File Operation = 文件操作
Import File = 導入文件
Extract Libs = 提取庫文件
No Libs! =
Import File and Extract Libs = 導入文件並提取庫
File type = 文件類型
The file size is too large. = 文件尺寸過大
Please selected the file type. = 請選擇文件類型
No component was found! = 沒有發現器件
Import successfully = 導入成功
Import failed = 導入失敗
Click OK to continue with the import = 點擊確認將繼續導入文件
Select None=全不選

#Dialog Modify Symbol Information
Modify symbol information = 修改符號信息
Spice Prefix = 仿真編號
Hide Pin = 隱藏引腳
Pin Manager = 引腳管理器
When a power pin is hidden, it will be marked as netlabel, you don't need to wire it. If you use it as simulation, please show it or create a GND/VCC Net for it. = 當一個電源引腳被隱藏，它將被標記為網絡標籤，你不需要連接它。如果您使用它進行仿真，請將它顯示或為它創建一個GND/VCC網絡。
Assign = 分配
Supplier.bom = 供應商
LCSC.bom = LCSC編號
Price = 價格
Quantity.bom = 數量
Package.bom = 封裝
Components.bom = 元件編號
Manufacturer Part.bom = 製造商料號
Manufacturer.bom = 製造商

One-click Purchasing at LCSC = 從立創商城購買
Order Parts = 購買元件/檢查庫存
Export BOM = 導出BOM
Upload to LCSC ERP =
Order SMT Parts =
No components, upload failed! =
Upload to LCSC ERP failed, please try again later. =
Current BOM upload to Chip Manager of LCSC successfully, click "OK" button to access Chip Manager. =
Upload to LCSC ERP failed, found some components miss some properties value, please check property "Footprint, Manufacturer Part" value if exist. =
Export PCB BOM = 導出 PCB BOM
Export Schematic BOM = 導出原理圖BOM
ID.bom = 編號
Name.bom = 元件名稱
[bom]
Name = 元件名稱
LCSC Assembly=立創貼片零件
Value = 元件名稱
ID = 編號
Supplier = 供應商
LCSC = LCSC編號
Price = 價格
Quantity = 數量
Package = 封裝
Components = 元件編號
Manufacturer = 製造商
[/bom]
Manufacturer Part = 製造商料號
Part Number =
Part Code =

#Dialog Run
Run your simulation = 運行仿真
Transient = 暫態
Maximum Timestep = 最大步長
Stop Time = 終止時間
Start Time = 起始時間

AC Analysis = 交流分析
Type of Sweep = 描述類型
Number of points = 數據點
Start Frequency = 起始頻率
Stop Frequency = 終止頻率

DC sweep= 直流掃描
Source to Sweep = 掃描源
Start Value = 起始值
Stop Value = 終止值
Increment = 步進
DC Transfer = DC 變換
Output = 輸出
Source = 源

DC op pnt = 靜態工作點
Compute the DC operating point treating capacitances as opens and inductances as shorts = 計算靜態工作點，電容開路，電感短路

#Dialog Share Info
Active File = 當前文檔
Active Project =當前工程
Readonly = 只讀
Editable = 可編輯
Active file's owner project page = 當前文檔所屬工程的頁面
Active project editor page = 當前工程的編輯器打開網址

#Dialog Document Recovery
All Projects = 所有工程
Document Recovery = 文檔恢復
Unsaved files=未保存的文檔
Please select a file! = 請選中一個文檔
Please expand the folder first, then select a document to recover. = 請先展開文件夾，再選中一個文檔備份進行恢復。
Are you sure you want to remove this backup? = 您確定要刪除該備份嗎？

#Dialog Find Libs
Search = 搜索
Search Results = 搜索結果
Search and press Enter = 按回車鍵搜索
Keywords at least 3 characters = 關鍵字至少3個字符
Assembled = 可貼片
Verified = 已認證
In stock = 可購買
{page} of {pagecount} pages = 第 {page} 頁 / 共 {pagecount} 頁
Common Modules = 通用模塊
User Contributions = 用戶貢獻
More = 更多
Modify Model... =
Add Favorite = 添加收藏
Remove Favorite = 取消收藏
Add Sub Part = 添加子庫
Add Sub Parts... =
Please enter how many sub parts need to be added =
Untagged = 無標籤
Package = 封裝
package = 封裝
Title(PartNO)=標題(零件名稱)
No Data! = 沒有數據
Quantity = 數量
Manufacturer Part = 製造商料號
manufacturer Part = 製造商料號
Manufacturer = 製造商
manufacturer = 製造商
voltage = 電壓
Library = 元件庫
LCSC Assembled = 立創貼片
JLCPCB Assembled = 嘉立創貼片
User Contributed = 用戶貢獻
Symbol = 符號
Follow = 關注
Types = 類型
Classes = 庫別
power = 功率
Power = 功率
LCSC Part# = 立創商城編號
LCSC Stock = LCSC 庫存
Report Error... = 報告錯誤...
Report Error = 報告錯誤
Thanks for your feedback! = 感謝您的反饋！
Report error success, thanks for your report! = 報告錯誤成功，感謝您的反饋！
The content must be at least 2 characters! = 內容至少包含兩個字符！
This library is user contributed, please check before using. = 這個庫是用戶貢獻庫，使用前請注意檢查。
[lib]
All = 全部
System = 系統庫
Personal = 個人庫
Created = 創建的
Favorite = 收藏的
No Team found. Please join or create a team first. = 無團隊，請先加入或創建一個團隊。
Create a team = 創建團隊
No follow user found. Please follow your friend first. = 無關注用戶，請先進行關注。
[/lib]


BUY = 購買
In Stock = 件庫存
Out of Stock = 缺貨
Minimum = 起訂量
Distributor = 銷售商

Capacitance = 容量
Frequency Tolerance = 誤差
Power (Watts) = 功率
Power - Max = 功率(最大)
Frequency = 頻率
Voltage Rating(Vdc,Vac) = 額定電壓
Voltage = 額定電壓
Current Rating = 額定電流
Rated current = 額定電流
Resistance (Ohms) = 阻值
Resistance(Ohms) = 阻值
Inductance = 電感係數
FET Type = 類型
Current Rating(Max) = 額定電流(最大)
Impedance @ Frequency = 阻抗@頻率
Voltage - Input (Max) = 輸入電壓(最大)
Voltage - Input (Min) = 輸入電壓(最小)
Voltage - Supply = 供電電壓
Voltage - Max = 最大電壓
Current - Output = 輸出電流

#Dialog Export Your Works
Export your works = 導出你的作品
Export to = 導出為
Zoom = 放大
Image Type = 圖形類型
Qualify = 品質
0 means real size = 0代表實際尺寸
Merged layer = 合併層
Separated layer = 分離層
Paged layer = 分頁層
Layer = 層
Export = 導出
Mirror = 鏡像
TopLayer = 頂層
BottomLayer = 底層
TopSilkLayer = 頂層絲印層
Protractor Properties = 量角器屬性
BottomSilkLayer = 底層絲印層

BoardOutLine = 邊框層
TopAssembly = 頂層裝配層
BottomAssembly = 底層裝配層
Mechanical = 機械層
DocumentLayer = 文檔層
Inner{number} = 內層{number}
Substrate{number} = 基板{number}
Color=色彩
Full Color = 全彩
Canvas Setting = 畫布設置
Full Graphics = 全圖形
Assembly Drawings = 裝配圖
Object Outlines = 元素邊界
Invalid file format = 無效的文件格式
Failed to export file = 導出文件失敗
Download now = 立即下載
Wire Width = 線寬
Sheet = 頁面
Merged sheet = 合併頁面
Separated sheet = 單獨頁面
Engine = 引擎
Exporting PDF = 導出PDF
Export 3D Model = 導出3D模型
[exportDocument]
Size = 尺寸
[/exportDocument]

#Dialog Import Changes
Confirm Importing changes information = 確認導入信息
You can't undo this operation, Please run a Design Rule Checking (DRC) after this operation. = 你不能撤銷該操作, 完成該操作後,請運行一次設計規則(DRC)驗證
Apply Changes = 應用修改
This is a simple Design Rule Checking (DRC). = 這只是簡單的設計規則(DRC)驗證
It just can help you to find the obvious errors = 僅能幫你發現部分很明顯的錯誤
There are some unfinished nets, do you want to check the nets first? = 存在未完成的網絡，是否先檢查網絡？
Yes, Check Nets = 是，檢查網絡
No, Keep Going = 否，繼續進行

#Dialog Layer Manager
Configured = 可配置
Layer Name = 層名稱
TopPasterLayer = 頂層助焊層
BottomPasterLayer = 底層助焊層
TopSolderLayer = 頂層阻焊層
BottomSolderLayer = 底層阻焊層
TopPasteMaskLayer = 頂層錫膏層
BottomPasteMaskLayer = 底層錫膏層
TopSolderMaskLayer = 頂層阻焊層
BottomSolderMaskLayer = 底層阻焊層
ComponentShapeLayer = 元件外形層
LeadShapeLayer = 引腳外形層
ComponentMarkingLayer = 元件標識層
Ratlines = 飛線層
Ratlines Color = 飛線顏色
Manage Colors = 管理顏色
BoardOutline = 邊框
Multi-Layer = 多層
Hole = 通孔
DRCError = 錯誤
Setting = 設置
Drawing area = 畫圖區域
Export area =導出區域
Transparency(%) = 透明度(%)
Copper Layer = 銅箔層
Signal = 信號層
Plane = 內電層
Non-Signal = 非信號層
Other = 其他
Please delete all the objects of the layers first! The layers are: = 請先刪除對應層的全部元素! 對應層為：
You are converting Signal Layer to Plane Layer, There're some non-track objects remain on following layers. Please delete the objects manually on the canvas. = 你正在將信號層轉為內電層。以下層中有些非導線的元素，請手動將它們刪除。
Please delete all the objects of this layer first! = 請先刪除該層的所有元素！

#Dialog Fabrication Output
Create Files = 輸出文件
Check your {0}Gerber files{1} carefully before sending them to the factory = 發送到工廠前，請仔細檢查你的{0}Gerber文件{1}
Download free Gerber Viewer (gerbv) = 下載免費開源的Gerber文件查看軟件
Before generating the Gerber files = 在生成Gerber前
Please check the packages size and orientation carefully. =請仔細檢查封裝尺寸，極性。
Please check for Design Rule Checking (DRC) errors in the Design Manager. = 請在設計管理器檢查設計規則(DRC)錯誤。
Please rebuild the copper area after modifying tracks and packages. = 請確保在修改封裝和布線後已經重新鋪銅。
After generating the Gerber file, please use the {0}Gerber Viewer{1} to check whether it conforms to the design requirements. = 在生成Gerber後，請使用{0}Gerber預覽器{1}查看Gerber圖形是否符合設計要求。
Order PCB/SMT = 一鍵下單PCB/SMT
Found the complicated polygon that object cannot be generated at Gerber, please remove or replace = 發現複雜多邊形圖元無法輸出到 Gerber，請刪除或者更換
ID: {id}, Object: {object}, Location: {location} = ID: {id}, 圖元: {object}, 位置: {location}

#Dialog DRC
Item = 項目
Value = 值
value = 值
Unit = 單位
Track Width = 線寬
Track to Track = 線距
Track to Pad = 線到焊盤
Pad to Pad = 焊盤到焊盤
Via to Via = 過孔間距
Via Hole Size = 過孔直徑
Realtime DRC = 實時設計規則檢測
{0} is too small! = {0}的值太小
Invalid DRC Rule = 無效的DRC規則
Rule = 規則
Via Diameter = 孔外徑
Via Drill Diameter = 孔內徑
Net List = 網絡列表
Rule = 規則
Set Rule = 設置規則
Check Object to Copper Area = 檢測元素到鋪銅的距離
Show DRC Boundary while Routing = 在布線時顯示DRC安全邊界
Check Object to Board Outline = 檢測元素到邊框的距離
Rule name already exists! = 規則已存在！
You should not delete default rule! = 不能刪除默認的規則！
Rule list contains invalid rule setting! = 發現有無效的規則設置！
Duplicate rule name exists! = 發現有重複的規則名稱！
via diameter is smaller than via drill diameter! = 孔外徑比孔內徑還小！
Currently rule name is not allowed to contain magical characters like . and $ = 目前規則名稱不允許出現「.」及「$」等特殊字符！
Track Width (min) =
Clearance (min) =
Via Diameter (min) =
Via Drill Diameter (min) =
Track Length (max) =
[drcRule]
All = 全部
[/drcRule]

#Dialog Hotkey
Change Canvas Unit = 修改畫布單位
Copy Selected Object(s) by Reference Point = 根據參考點複製元素
Fullscreen = 全屏
Undo the Previous Draw = 撤銷到上次繪製
Set Canvas Origin by Coordinate = 打開原點坐標對話框
Switch to the Next Signal Layer = 切換到下一個信號層
Switch to the Previous Signal Layer = 切換到前一個信號層
Switch object to top layer or bottom layer = 將元素切換到頂層或底層
Cycle Forward to the Next Open Tabbed Document = 循環切換到下一個文檔
Cycle Backward to the Previous Open Tabbed Document = 循環切換到前一個文檔
Switch to the Previous Layer(on the Numeric Keypad) = 切換至上一個層(數字鍵盤)
Switch to the Next Layer(on the Numeric Keypad) = 切換至下一個層(數字鍵盤)
Toggle Layers Which is Not Active = 顯示或隱藏未選中的層
Hotkey Setting = 快捷鍵
Document Type = 文檔類型
Shortcut = 快捷鍵
Function = 功能
ALL = 所有
SCH = 原理圖
Rotate Selected Objects = 旋轉所選圖形
Scroll or Move Selected Left = 向左滾動或者左移所選圖形
Scroll or Move Selected Right = 向右滾動或者右移所選圖形
Scroll or Move Selected Up = 向上滾動或者上移所選圖形
Scroll or Move Selected Down = 向下滾動或者下移所選圖形
Set canvas origin to the center grid of graphics in symbol; Set canvas origin to the center of pads in footprint. = 在符號設置原點到圖形中心格點；在封裝設置原點到焊盤中央。
Cross Document Paste = 跨文檔粘貼
Explore & Find Components = 瀏覽與查找元件庫
Select All=全選
Cancel Current Drawing=取消繪製
Save = 保存
Drag Tool=拖動
Draw Wire=繪製導線
Draw Bus=繪製總線
Bus Entry=總線分支
Junction=節點
Net Flag GND=標識符GND
Net Flag=標識符
Draw Polyline=繪製折線
Draw Polygon=繪製多邊形
Draw Bezier=繪製貝塞爾曲線
Draw Arc=繪製圓弧
Draw Rect=繪製矩形
Draw Ellipse=繪製橢圓形
Freehand Draw=自由繪製
Freedraw = 自由繪製
Draw Text=繪製文本
Edit Selected Symbol = 修改選中符號
Draw Track=繪製導線
Draw Circle=繪製圓形
Cycle Select Object at Current Location = 循環選擇當前位置的元素
Draw Dimension=繪製尺寸
Draw Connect=繪製連接線
Draw CopperArea=繪製鋪銅
Change to TopLayer;<br/>Change Selected Component's Layer to TopLayer; = 切換到頂層；<br/>切換選擇的元件的層到頂層；
Change to BottomLayer;<br/>Change Selected Component's Layer to BottomLayer; = 切換到底層；<br/>切換選擇的元件的層到底層；
Change to Inner1=切換到內層1
Change to Inner2=切換到內層2
Change to Inner3=切換到內層3
Change to Inner4=切換到內層4
Highlight Net=高亮網絡
Highlight Network =
Unhighlight Network =
Place Pad=放置焊盤
Place Via=放置過孔
Measure=測量距離
Change Routing Angle=改變布線角度
Change Routing Conflict = 改變布線衝突
Decrease Routing Width=減少線寬
Increase Routing Width=增加線寬
Decrease Snap Size= 減少柵格尺寸
Increase Snap Size=增加柵格尺寸
Change Copper Zone Visible or Invisible = 循環切換鋪銅區可見性
Rebuild All Copper Area = 重建所有鋪銅
Toggle PCB Net Display = 切換PCB網絡顯示
Show Property Dialog When Placing Object;<br/>Show Location Setting Dialog When Pasting Object(s) = 當放置元素時顯示屬性對話框;<br/>當粘貼時顯示定位元素對話框;
Show Property Dialog When Placing Object;<br/>Show Absolute Offset Dialog When Selecting Object(s);<br/>Show Location Setting Dialog When Pasting Object(s) = 當放置元素時顯示屬性對話框;<br/>當選中元素時顯示絕對偏移量對話框;<br/>當粘貼時顯示定位元素對話框;
Show Relative Offset Dialog When Selecting Object(s) = 當選中元素時顯示相對偏移量對話框
Open the FAQ Page = 打開常見問題頁面
Move Object(s) by Reference Point = 根據參考點移動元素
Choose Favorite Track Width While Routing = 布線時改變線寬值
Copy Selected Object(s) and Paste Repeatedly = 複製選中的元素連續粘貼

#My Projects Tree Menu
New Project = 新建工程
New Schematic = 新建原理圖
New PCB = 新建PCB
New Spice Subckt = 新建仿真子電路
Modify = 修改
Delete = 刪除
Add sub part = 增加子器件
Clone = 克隆
Version History = 歷史版本
Refresh List = 刷新列表
Create New Project = 新建工程
Delete = 刪除
Attachment = 附件
Archive = 歸檔
Transfer = 轉移
Manage Project = 工程管理

#Dialog Verify Package
Footprints Verification = 檢驗封裝

#Dialog Edit Polygon Pad points
Edit Points = 編輯坐標點
Center point is outside the pad = 中心點在焊盤外
Hole should be inside the pad = 孔必須在焊盤內
Hole is draggable = 可拖動孔來修改位置

#My Part Tree Menu
Clone = 克隆
Reload parts = 重新加載
Layers = 層

#Dialog Preferences
Language = 語言
Display Name = 顯示名稱
HotKey Sync = 同步熱鍵
My Theme Sync = 同步我的主題
Document Recovery Setting = 文檔恢復設置
Enable auto backup = 啟用自動備份
Maximum backup level = 最大備份級數
Auto backup interval = 自動備份間隔
days =
hours =
minutes = 分鐘
seconds =
Save to Server = 保存到服務器
Load from Server = 從服務器加載


#Dialog Schematic Library Wizard
Symbol Wizard = 符號嚮導
Style = 樣式
Picture = 圖片
Pin Names =引腳名字
Contributor = 貢獻者
contributor = 貢獻者
owner = 所有者

#Dialog Annotate
Annotate =標註
Scope=應用範圍
All pages =
Current page only = 僅當前原理圖
Selected components =
All Opened Schematics = 所有打開的原理圖
Method=方法
Re-annotate all=重新標註
Keep existing annotation = 保留原來的標註
Direction=方向
Rows=行
Cols=列
Reset =重置

#Dialog Order
Order... = 訂購...
PCB Qty.= 板子數量
PCB Thickness= 板子厚度
PCB Dimension= 板子大小
Automatic calculation = 自動計算
PCB Color= 阻焊顏色
Green = 綠色
White=白色
Blue=藍色
Red=紅色
Yellow=黃色
Black=黑色
Purple=紫色
Copper=銅色
Gold=金色
Silver=銀色
Surface Finish= 焊盤噴鍍
Hasl=有鉛
Hasl(Lead Free)=無鉛
ENIG=沉金

#Dialog Hot Key config
Restore All Default Shortcuts = 恢復全部默認快捷鍵
Save Changes = 保存修改



#Dialog Polyline Maybe Wire
To connect electrical elements, please use Wire (W hotkey) and not Line (L hotkey). = 請用導線(快捷鍵W)來連接電氣節點,而非用直線(快捷鍵L).

Anonymous File = 匿名文檔
Anonymous File can not be cloned, but you can open it, then save it as a new file. = 匿名文檔不能克隆，可以打開後再另存為新文檔。
Free Documents = 自由文檔
You must close the file before delete it! = 刪除前請先關閉該文件！
Offline Project = 離線工程

#Message box
Confirmation = 確認
Alert = 警示
Information = 信息
information = 信息
Prompt = 詢問
Error = 錯誤
error = 錯誤
error! = 錯誤!
Warning = 警告
Imported ok! = 導入成功
Some changes have not been saved. = 文檔修改尚未保存
Your file hasn't been saved. Please save first! = 你的文檔沒有保存，請先保存!
Your file hasn't been saved. Are you sure you want to close it? = 你的文檔沒有保存，確定關閉它嗎?
Error! Please try again later. = 發生錯誤！請稍後重試。
Are you sure you want to reload this page? = 確定要重新加載當前頁面嗎？
Are you sure you want to leave this page? = 確定要離開當前頁面嗎？
Confirm Reload = 確認重新加載
Confirm Close = 確認關閉
Reload this page = 重新加載
Leave this page = 離開該頁面
Stay on this page = 留在該頁面
Don't reload = 不重新加載
No connect flag only can be placed on Pin dot or the wire which is connected one Pin. = 非連接標誌只能放置在引腳端點或者連接單個引腳的導線端點上。
can not be placed on the wire which is placing No Connect Flag. = 不能放置在含有非連接標誌的導線上。
The footprint transfer to LCSC library class successfully = 封裝已成功轉移到立創商城庫別
Device/Footprint goes into "SMT Device/Footprint Verified" list successfully = 器件/封裝已經成功進入「已審核SMT器件/封裝」列表

Load failure! = 加載失敗
Load projects failed = 加載工程列表失敗
error info = 錯誤信息
error information = 錯誤信息
Guest can't create a new project. Please login! = 訪客不能創建新工程，請先登錄
Please create a project before you do this! = 執行該操作前請先創建一個新工程
Add Part success = 成功添加模塊
Click the new part and then edit it!= 點擊新添加的子庫，然後編輯它
Delete my work = 刪除我的作品
Delete my work. (Only deletes it from this list but not from the server) = 刪除該文檔(僅從該列表內刪除，文檔沒有被真正的刪除)
Do you confirm this? =你是否確認該操作?
Successfully deleted! = 成功刪除！
Successfully Copied! = 成功複製！
Cloning success! = 克隆成功!
Your title is too short! = 你的文件標題太短!
Remove this part = 移除這個文件
Find and Jump to ...  =查找並跳轉到該器件...
Please type the prefix, such as U1, R1, C1 = 輸入該器件的標識符，如U1,R1,C1
Zoom as 1:1, you can print it and then create artwork for etching the PCB. = 1:1縮放，你可以打印該文件，然後自己腐蝕PCB
Exporting your works! = 導出你的作品
Guests can't import a file. Please login! = 訪客不能導入文件，請登錄先!
Please create a project before you import a file! = 導入文件前請先創建一個工程
Import your LTspice file! = 導入你的LTspice文件!
Open LTspice file = 打開LTspice文件
Open EasyEDA file =
Please make sure the selected LTspice file is a file saved in LTspice V and above. = 請確保選擇的LTspice文件是LTspice V 及以上版本保存的文件.
Saved successfully! = 保存成功
Save failed! = 保存失敗
Can not place parts into this document. = 不能放置該器件在本文檔中，文檔類型不匹配
User Package = 用戶封裝
System Package = 系統封裝
File error = 文件錯誤
Please save your file first! = 請先保存你的文件
Email address is too short! =郵件地址太短
You have not selected a file to upload. = 你還沒有選擇文件
Update = 更新
No changes, the PCB already matches the schematic! = 無變更，PCB與原理圖已經匹配！
Only public files can be shared =只有公開文件才能被分享，當前文件是私有文件
Conversion to PCB has failed! = 轉換PCB失敗
Your username is too short! =用戶名太短
Your password is too short, it must be more than 6 characters! = 密碼太短，必須大於6個字符
Conflicting shortcut = 熱鍵衝突
There is an empty PCB file. Please first run Convert Schematic to PCB... from the schematic =這是一個空白PCB,請先打開原理圖運行"原理圖轉PCB"
This file has been modified, are you sure you want to run this simulation before saving it first? =該文檔已經被修改，你確認仿真它?也許你應該先保存它。
Please enter the Maximum Timestep! = 請填寫最大步長
Please enter the Stop Time! = 請填寫終止時間
All of these fields are needed. = 所有選項必須填寫
Either your spice netlist is too big or the server is busy. Please try again later. = 你的spice 網絡表太大,或者服務器太忙,稍後再嘗試
Your spice netlist is too big! Try breaking your circuit into smaller simulatable blocks. = 你的spice網絡表太大，請把電路差分成子電路仿真
Too many users in simulation. Please try again later! =太多用戶正在運行仿真，稍後再嘗試.
Due to limited server resources, please wait 10 seconds for the interval in every time simulation. = 由於服務器資源限制，每次仿真請等待10秒。
Your circuit is too complex, we have not enough CPU resource to support this simulation, please reduce your circuit as small as you can. = 您的電路有點複雜，我們沒有足夠的資源來支持你的這次仿真，請儘可能簡化你的電路或減少仿真時長。
Simulation is queuing, try again after 30s. = 仿真正在排隊中，請稍後再試。
Timeout = 仿真超時
Demo accounts don't support simulation, please login first=不允許演示賬號仿真，請登錄
Please login first = 請先登錄
The schematic is showing errors, please check the simulation report carefully! =這個電路中貌似有些錯誤，請仔細閱讀仿真報告,嘗試找出這些錯誤。
Simulation too long, maybe your schematic is too complex. = 仿真超時,也許你的電路太複雜.
Non-simulated file = 非仿真文件
This file can only be opened in standard mode. To open it, please switch to standard mode. = 該文件只能在標準模式打開，如要打開請切換至標準模式
Load your preferences success! = 成功加載你的個人偏好!
Save your preferences success! = 成功保存你的個人偏好!
Update subckt ok! = 更新子電路成功 。
Clone your file = 克隆你的文件
Please type a new file name = 請輸入一個新的文件名
Create file failure! = 創建文件失敗
Schematics and PCBs can't be imported under My Libs folder, please choose a different folder = 原理圖與PCB不能導入到My Libs目錄下，請選擇其它目錄
Libraries to be imported under My Libs folder = 庫文件僅能導入到My Libs目錄下
Please choose only the libraries needed = 請僅僅選擇需要的庫文件
Maximum import is 200 libs at one time! = 我們不支持一次導入多於200個庫文件
You libraries will be found under the My Libs folder = 你的庫文件將出現在My Libs文件夾下
Add to Library = 添加到庫中
No items have been checked! = 沒有勾選任何器件!
Nothing was found, please create it for yourself= 什麼也沒有找到，你可以自己創建它
Search result = 搜索結果
At least 3 characters needed = 最少3個英文字母
Add to my Favorite Parts = 添加到我的收藏
Added it OK. Please find it in your Favorite Parts = 添加成功，請檢查你的收藏器件
Please select its parent node = 請選擇它的父節點
Libraries can not be exported as active project pdf. =庫文件不能作為工程PDF文件導出
Error:No GND = 錯誤：沒有GND(地)
This circuit does not have GND. Please select GND from the circuit tool to add to the circuit. = 該電路沒有GND(地)，請從電路工具中選取GND(地)加入到電路中。
Current circuit doesn't has Voltage Resource or Current Resource symbol, please place it first at left side EElib or Spice Library. = 當前電路沒有電壓源或電流源符號，請先在左側基礎庫或仿真庫放置。
Probe can not connect with ground(GND)! = 探針不能與地(GND)連接！
Spice symbols's properties can't be empty. = 請完善仿真器件參數。
Error:No Spice Symbol = 沒有仿真模型
Simulation limit = 仿真限制
There is a multimeter in the circuit that needs to be simulated using the emulation command .tran or .op = 電路中存在萬用表，需要使用仿真命令 .tran 或 .op 進行仿真
An oscilloscope exists in the circuit and needs to be simulated using the simulation command .tran = 電路中存在示波器，需要使用仿真命令 .tran 進行仿真
There are components in this circuit that do not have a simulation model. Please use the base library component of the simulation mode for simulation. = 該電路存在沒有仿真模型的元器件，請使用仿真模式的基礎庫元件進行仿真。
Circuit does not have a probe = 該電路沒有探針
Make sure your pin numbers are even numbers = 請確認你輸入的引腳的個數是偶數
Duplicate Components Prefix = 器件標註重複
All components are hidden successfully! = 全部元件隱藏成功！
All ratlines are hidden successfully! = 全部飛線已隱藏成功！
Hidden the ratline of net {netName} successfully! = 網絡 {netName} 的飛線隱藏成功！
Duplicate Component Prefix = 元件標註重複
{0} exist = {0} 已存在
Modify successfully, but {0} already exists =
There are some invalid packages, are you sure? = 有些封裝是無效的，你確認該操作?
Invalid Characters, library only allows [0-9a-zA-Z-_] = 非法字符，庫文件只允許[0-9a-zA-Z-_]等字符
Annotation success = 標註成功
If you accept this annotation operation, please save your files. If not, close your files without saving. = 假如你接受該標註操作，請保存你的文件.否則直接關閉你的文件不要保存它.
This file can't be saved under libs project. Please choose other project or create a new project=該文檔不能保存在庫工程下，請選擇其它工程，或者創建一個新的工程
Your file is unsaved.= 你的文檔沒有保存
You can close the editor now. Have a good day! = 現在你可以關閉編輯器，祝生活愉快!
Successfully logged out = 退出成功
You have at least one unsaved file open. Please save it or close it. = 你至少有一個文檔沒有保存，請保存它或者關閉它
Please select a reference point = 請選擇參考點
Please save your file before this operation = 請先保存文件後再進行該操作
Please open a PCB document = 請打開一個PCB文檔
Please save your file before '{0}'. = 進行{0}前請先保存你的文件。
Please try again after saving this file. = 保存文檔後再試一次
This text can not be empty! = 此處文本不能為空！
Export to Altium fail, please try again or contact us. = 導出Altium失敗，請再次嘗試或聯繫我們。
Connecting to server = 正在連接服務器
Please login before asking for help = 尋求幫助前請先登錄
This file has been modified, please save it first! = 該文檔已經被修改，請先保存!
Remove this param = 移除該參數
You cannot drag a part to the canvas, please click the part and move the cursor to the canvas and then right-click to place. = 不支持直接拖動元件到畫布中，請點擊元件，再移動鼠標到畫布，再點擊鼠標左鍵進行放置。
Undo/Redo temporary error = 撤銷/重做臨時錯誤
We are sorry but there is an unpredictable error in the undo/redo process. This problem will be fixed soon but in the meanwhile it is safe to continue working on your design. = 撤銷重做暫時出現不可預知錯誤,我們將儘快修復這個問題, 同時你的設計作品是安全的,你可以放心繼續工作.
The schematic has duplicate prefixes of the components, please make them unique. You can check them using the Design Manager. = 當前原理圖存在重複的元件編號，請修改它們並確保是唯一的。你可以在設計管理器中查看它們。
Found duplicated prefix components, can not Import Changes, please modify the duplicated prefix or delete related component. = PCB存在相同編號器件，無法導入更新，請手動修改重複的編號或者刪除對應的器件。
Please click the below help button to find out how to fix this problem. = 請點擊下面的幫助按鈕獲知如何修復這個錯誤
Please create a board outline! Click the help button to find out how to create a board outline. = 請先創建PCB邊框, 點擊幫助按鈕了解如何創建PCB邊框
Can not fetch files from server, please check your network and try again = 不能從服務器端獲取文檔, 檢查網絡後重試
Please open a schematic first! = 請先打開一個原理圖.
Can not find the schematic of this PCB = 不能找到該PCB對應的原理圖
invalid points! = 含有無效坐標點
This file does not support this operation. = 該文檔不支持該操作
Net Name Conflict = 網絡名衝突
Net name = 網絡名
{0} are in the same wire, please remove others and just keep one. = {0} 在同一條導線上，請刪除其它的，僅保留一個
This field can't be removed! = 該字段不能被移除
Annular ring of the pad/via is too small = 導電孔或插件孔單邊焊環過小
The size of the hole cannot exceed the size of the pad = 焊盤上孔的尺寸不能超過焊盤的大小
Are you sure you want to create a multi-sheet designs? = 你確定要創建一個多頁原理圖工程？
Are you sure you want to create a {0}multi-sheet designs{1}? = 你確定要創建一個{0}多頁原理圖{1}工程？
Please build the copper area! Click the help button to find out how to build the copper area. = 請重建鋪銅層，點擊幫助按鈕獲取更多信息
Suggest to set a package for this component first! = 建議先對這個零件設置封裝再保存!
Please select an opened document first. = 請先選擇一個打開的文檔
Some files failed to load. Please reload the page. = 部分文件加載失敗，請重新加載頁面。

#UI Intro
Skip = 跳過
« Back = « 上一個
Next » = 下一個 »
Done = 完成
This is the user management menu. = 這裡是用戶菜單
This is the toolbar. = 這裡是頂部工具欄
This is the navigation list. Under here you can find projects, files, parts and libraries. = 這裡是文檔導航，在這裡查看工程、文檔、庫。
Show or hide the toolbar to the top of the window here. = 這裡是頂部工具欄切換開關
Show, resize or hide the left sidebar to the left of the window here. = 這裡是左側欄切換開關
Show or hide the right sidebar to the right of the window here. = 這裡是右側欄切換開關

#Standard libs
Passive Components = 無源器件
Power Supply = 電源
Diodes = 二極管
Regulator = 穩壓器件
Transistor = 晶體管
Transformers = 變壓器
Gates = 邏輯門
Vacuum Tubes = 真空管
Switch = 開關
Relay = 繼電器
Capacitor(US) = 電容(美式)
Capacitor(EU) = 電容(歐式)
Capacitor(EU)2 = 電容(歐式)2
Electrolytic Capacitor(US) = 電解電容(美式)
Electrolytic Capacitor(EU)= 電解電容(歐式)
Electrolytic Capacitor(US)2 = 電解電容(美式)2
Electrolytic Capacitor(EU)2 = 電解電容(歐式)2
Inductor(US) = 電感(美式)
Inductor(EU) = 電感(歐式)
Potentiometer_US = 可變電阻_美標
Potentiometer_EU/IEC = 可變電阻_歐標
Potentiometer_3D = 可變電阻_3D
Resistor(US) = 電阻(美式)
Resistor(EU) = 電阻(歐式)
Resistor 45 Deg(US) = 電阻 45 度(美式)
Resistor 45 Deg(EU) = 電阻 45 度(歐式)
Variable Capacitor(US) = 可調電容(美式)
Variable Capacitor(EU) = 可調電容(歐式)
Variable Resistor(US) = 可調電阻(美式)
Variable Resistor(EU) = 可調電阻(歐式)
Variable Inductor(US) = 可調電感(美式)
Variable Inductor(EU) = 可調電感(歐式)
Varistor = 壓敏電阻
Inductor2(US) = 電感2(美式)
Inductor2(EU) = 電感2(歐式)
Battery = 電池
Voltage Source = 電壓源
Current Source = 電流源
CCCS(Current Controlled Current Source) = CCCS(電流控制電流源)
CCCS2(Current Controlled Current Source) = CCCS2(電流控制電流源)
VCCS(Voltage Controlled Current Source) = VCCS(電壓控制電流源)
VCVS(Voltage Controlled Voltage Source) = VCVS(電壓控制電壓源)
CCVS(Current Controlled Voltage Source) = CCVS(電流控制電壓源)
CCVS2(Current Controlled Voltage Source) = CCVS2(電流控制電壓源)

BV(Behavioral Voltage Sources) = BV(行為電壓源)
BI(Behavioral Voltage Sources) = BI(行為電流源)
Epoly(Non-linear Voltage Source) = Epoly(非線性電壓源)
Gpoly(Non-linear Current Source) = Gpoly(非線性電流源)

Diode = 二極管
LED = 發光二極管
LED_3D = 發光二極管_3D
Schottky Diode = 肖特基二極管
Varactor Diode = 變容二極管
Zener = 穩壓二極管
Unidirectional TVS Diode = 單向瞬態電壓抑制二極管
Bidirectional TVS Diode = 雙向瞬態電壓抑制二極管
Diac = 雙向觸發二極管
Bridge = 整流橋
78XX = 78系列穩壓器
79XX =  79系列穩壓器
LM317 = LM317
LM337 = LM337
TL431 = TL431
BJT(NPN) = 三極管(NPN)
BJT(PNP) = 三極管(PNP)
MOSFET(Nch) = 場效應管(N溝道)
MOSFET(Nch) Depletion Four-pins = 耗盡型場效應管(N溝道)4腳
MOSFET(Nch) Enhancement = 增強型場效應管(N溝道)
MOSFET(Nch) Enhancement Four-pins = 增強型場效應管(N溝道)4腳
MOSFET(Pch) = 場效應管(P溝道)
MOSFET(Pch) Depletion Four-pins = 耗盡型場效應管(P溝道)4腳
MOSFET(Pch) Enhancement = 增強型場效應管(P溝道)
MOSFET(Pch) Enhancement Four-pins = 增強型場效應管(P溝道)4腳
JFET(Nch) = 結型場效應管(N溝道)
JFET(Pch) = 結型場效應管(P溝道)
Darlington NPN = 達林頓(NPN)
Darlington PNP = 達林頓(PNP)
MESFET(Nch) = 金屬半導體場效應晶體管(N溝道)
MESFET(Pch) = 金屬半導體場效應晶體管(P溝道)

IGBT = 絕緣柵雙極型晶體管
SCR = 可控硅
Triac = 雙向晶閘管
Transform(US) = 變壓器(美式)
Transform(EU) = 變壓器(歐式)
Transfrom(NEUTRAL-CTR TAP)(US) = 中心抽頭變壓器(美式)
Transfrom(NEUTRAL-CTR TAP)(EU) = 中心抽頭變壓器(歐式)
Mutual Inductors = 互感
Mutual Inductors2 = 互感2
Or Gate = 或門
Xor Gate = 異或門
And Gate = 與門
Nor Gate = 或非門
Nand Gate = 與非門
Not Gate = 非門
Xnor Gate = 同或門
Tube Diode = 真空二極管
Tube Triode = 真空三極管
Tube Tetrode = 真空四極管
Tube Pentode = 真空五極管
Voltage Controlled Switch = 電壓控制開關
Current Controlled Switch = 電流控制開關
SPST ON = 單刀單閘(合)
SPST OFF = 單刀單閘(開)
Fuse = 保險絲
555 = 555定時器
555(Style2) = 555定時器(Style2)
Speaker = 喇叭
XTAL = 晶振
5pin Operational Amplifier = 5端運放
3pin Operational amplifier = 3端運放
Transmission Line = 傳輸線
Voltmeter = 電壓表
Ammeter = 電流表
LAMP = 燈泡
Opto Transistor = 光電三極管

#Server Message
Need login = 需要登錄
Bad password = 錯誤的密碼
We can't find your username or your email, please check it! =我們不能找到這個用戶名或者郵件,請仔細檢查
Make sure your uploaded file size is less than 3MB!=請確保您上傳的文件大小不超過3MB！
Bad file type = 錯誤的文件類型
Empty file or bad file type, ensure your file is Eagle 6.0+  = 錯誤的文件類型,請確認你的eagle文件版本大於6.0
This operation not supported on demo account = 演示賬號禁止該操作
Can not share this file under a private project, please set the active project to public! = 不能分享私有文檔，請把但前工程設置為公開
Login Failed Too many attempts. If you forgot your password, please {0}reset your password{1} or send an email to support@easyeda.com = 密碼錯誤次數太多，假如忘記密碼，請點擊{0}重置密碼{1}

#Dialog Common Buttons
Common Buttons Setting = 按鈕設置
Menu Setting... = 菜單欄設置...
Show/Hide = 顯示/隱藏
Move Up = 上移
Move Down = 下移
Reset All = 重置
Zoom = 縮放
Place Pin = 放置管腳

#System Setting Dialog
System = 系統
Zoom Mode = 縮放方式
Scroll Key = 滾輪縮放
CTRL + Scroll = CTRL+滾輪
Canvas Coordinate System = 畫布坐標系統
SVG Coordinate = SVG坐標系
Cartesian Coordinate = 笛卡爾坐標系
Open Wizard Dialog for New Schematic = 新建原理圖時打開嚮導
Default Unit = 默認單位
Canvas Zoom Effect = 畫布縮放效果
Quality Priority = 質量優先
Speed Priority = 速度優先
Rotation Step = 每次旋轉角度
Add Teardrop Automatically = 自動添加淚滴
Assign Net for Free Track/Arc/Circle = 為自由導線/圓弧/圓分配網絡
Open Wizard Dialog for New PCB = 新建PCB時打開嚮導
Rebuild Plane Automatically = 自動重建內電層
The Track's Routing Follows Component's Rotation = 元件旋轉時導線跟隨
Display Pad's Number and Net = 焊盤同時顯示網絡與編號
Favorite Track width = 常用導線寬度
Track Width Setting = 導線寬度設置

#Dialog Access Control
Permissions = 權限
Operations = 操作
Access Control = 訪問控制
Project Access Control = 工程訪問控制
Reject = 拒絕
Add User = 添加用戶
Bad email address = 錯誤的郵件地址
Permissions Error =

# error info from backend
Can't find this email address in EasyEDA. Your partner must be an EasyEDA user. = 用戶不存在.

#Dialog waveForm
Grid Background = 網格背景
Pane Background = 面板背景
WaveForm Config = 波形配置
Export Waveform = 導出波形為CSV文件


#attr-canvas-grid-style
dot = 點
line = 實線

#attr-canvas-frame-size
Other = 其它
A4 Portrait = A4縱向
A4 Landscape = A4橫向
A3 Portrait = A3縱向
A3 Landscape = A3橫向
A2 Portrait = A2縱向
A2 Landscape = A2橫向
A1 Portrait = A1縱向
A1 Landscape = A1橫向
Landscape = 橫向
Portrait = 縱向

#Stroke Style
solid = 實線
dashed = 短劃線
dotted = 點線

#Solid Region
Solid Region = 實心填充
Type = 類型
type = 類型

#Dialog Libs Management
Report error = 報告錯誤
Please give us some information to help us find the problem. = 請給我們一點提示以找到錯誤信息
Cannot place parts into this document: Schematic Symbols can only be placed into a Schematic; PCB Footprints can only be placed into a PCB. = 文檔類型不匹配,原理圖庫只能放置到原理圖上,PCB封裝只能放置到PCB上
Save it as a favorite part = 保存它為收藏器件
Only logged-in users can save this component as a Favorite Part but guest (Anonymous) users can place this component into their design directly. Would you like to place this component now? = 僅登錄用戶能保存它為收藏器件, 訪客允許放置該器件到畫布, 你願意現在放置該器件到畫布嗎?

#Others
Find libs=查找庫
My Projects=我的工程
My Parts=我的庫文件
My Modules=我的模塊
Assembly LCSC Components=立創貼片零件
Modules=模塊
SCH Module=原理圖模塊
PCB Module=PCB模塊
System IC=系統庫
LCSC (Official) = 立創商城
LCSC Electronics = 立創商城
Simple Mode = 精簡模式
Expand Mode = 放大模式
Help Verify = 幫助審核
Favorite Parts = 收藏器件
Shared With Me = 與我分享
Preview=預覽
Preview Window = 預覽窗口
System Default = 系統默認
User Defined = 用戶自定義
Theme = 主題
Theme Setting= 主題設置
Close=關閉
Open=打開
Toggle toolbar=打開/關閉工具欄
Toggle left bar=打開/關閉左側欄
Toggle right bar=打開/關閉右側欄
Reload=刷新
Mouse-X=光標X
Mouse-Y=光標Y
Mouse-DX=光標DX
Mouse-DY=光標DY
Bus entry x1 = 總線入口x1
Bus entry x2 = 總線入口x2
Bus entry y1 = 總線入口y1
Bus entry y2 = 總線入口y2
Yes=是
No=否
OK=確定
Confirm=確定
Continue = 繼續
Cancel = 取消
Update = 更新
Bus entry= 總線分支
Filter = 過濾
Check = 檢查
Share my work =
Share it by e-mail, IM, blog, etc. =

Copy the contents of this box into a text editor, then save the file. Paste the edited text back into this box and click Apply to update the display. = 拷貝文本框中的內容到記事本中，並保存它。你可以把內容粘貼到這裡並再次編輯它。
Copy the contents of this box into a text editor, then save the file with a .svg extension. You can edit it in Inkscape or open it in your browser. = 拷貝文本框中的內容到記事本中，以.svg後綴保存之。你可以用inkscape編輯它，也可以用瀏覽器打開它.
Content is too big to show, you can download it directly. = 內容太長無法直接顯示，你可以直接下載。
SVG format = SVG 格式
SVG File = SVG文件
Description should be no more than 250 letters = 描述不能超過 250 個字符
The file save operation has timed out. Try again and check your Internet connection. = 文件保存操作超時,檢測網絡連接並重試
Export Netlist = 導出網表
Notifications = 通知
Please select txt or json files. = 請選擇txt或json文件
Please select EasyEDA files. =
Failed to read file [{file}] = 讀取文件 [{file}] 失敗
[{file}] is not a valid json file = [{file}] 不是一個有效的JSON文件
Invalid parameters! = 無效參數
Download = 下載
Start = 開始
You have unsaved files, are you sure you want to log out without saving the files? = 還有未保存的文件，是否忽略它們並退出登錄？
Please use the web version to run this function. = 請在網頁版中使用該功能
Please save this file to you project! = 請保存文檔到工程中
Nothing changed = 沒有任何改變
Delete Node = 刪除節點
This layer is invisible. = 該層為不可見狀態
When the solid region is Board Cutout, please set the layer to Multi-Layer. = 實心填充為槽孔類型時，它的層必須設為多層。
You should not try to assign a net to a Board Cutout solid region. = 實心填充為槽孔類型時，不應設置網絡。
Net Length = 網絡長度
You can place a Pin in the schematic, but don't forget to group all of the Pins to a schematic component. Please click the help button to find out how to group them. If you just want to mark the wire, please use NetPort or NetLabel. = 原理圖中可以直接放置引腳，但別忘了將引腳組合到元件中。點擊幫助按鈕查看組合功能的使用。如果只是需要為導線做標記，請使用網絡端口或網絡標籤。
Please input the modification = 請填寫修改的內容
The content must be between {0} and {1} characters = 內容必須在 {0} 到 {1} 個字符之間
Please input a number between {0} and {1} =

Coming soon = 敬請期待
No tool = 無
Help us translate into your language = 幫助我們翻譯
Pad = 焊盤
Via/Hole = 過孔
PCB Layers = PCB層
Order PCB = 訂購PCB
Share = 分享
Free = 免費
Small = 小
Medium = 中
Big  = 大


Embed = Embed
HTML = HTML
URL = URL
BBCode = BBCode
PNG = PNG
Exporting as = 導出為
Exporting as image = 導出為圖片
Exporting as {0}SVG{1} file. = 導出為{0}SVG{1}文件
Exporting as pdf is recommended: pdf gives good quality printed output and a small file size. = 推薦導出為PDF，打印質量高，文件尺寸小。
Generate PCB Fabrication File(Gerber) = 生成PCB制板文件(Gerber)
PenWidth-Increase = 線寬增量

#Generate Gerber
Generate Gerber = 生成Gerber
Gerber View = Gerber預覽
Dimensions =
1-2 days =
Build Time =
Dimensions(Estimated) = 尺寸(估算)
PCB Qty = 板子數量
Copper Weight = 銅厚
PCB Price = PCB參考價格
Estimated Delivery Time = 快遞時間

HASL(with lead) = 有鉛噴錫
LeadFree HASL-RoHS = 無鉛噴錫
ENIG-RoHS = 沉金
Would you like to do Design Rule Checking (DRC) before generating the Gerber files? = 在生成Gerber之前是否檢查設計規則(DRC)？
Yes, Check DRC = 是，檢查DRC
No, Generate Gerber = 否，生成Gerber
No, Continue to order =
This PCB has uncompleted connection(s), do you want to check the connection(s)? = 該PCB存在未完成布線的網絡連接，是否檢查網絡？
Yes, Check Connection(s) = 是，檢查網絡
It will then redirect to the web site of a third-party JLCPCB with which we cooperate. Are you ready? = 即將前往我們的兄弟公司JLCPCB完成訂單，是否繼續？
Failed to submit your order, please contact us via support@easyeda.com for help. = 下單失敗，請聯繫support@easyeda.com獲取幫助。
Failed to submit your order, please contact us.  = 提交訂單失敗，請聯繫技術支持企業微信尋求幫助
Order data(Gerber, Pick and Place file, BOM) generated finish, please click OK button and continue. = 下單數據生成完畢，請點擊「 確定 」按鈕繼續。
[generateGerber]
Layers = 層數
[/generateGerber]

[version]
Switch = 切換
[/version]


Export your file, then print it yourself. = 導出文件再打印
Trace width is too small = 導線寬度太少
Share = 分享

Images Property = 圖片屬性
Connect Pad to Pad = 連接焊盤
Copper Area  = 鋪銅
Dimension  = 尺寸


Please check that you have used Wire and not Line to connect electrical elements. = 也許你應該使用導線(Wire)而不是折線(Polyline)連接電氣元素。
PCB Fabrication Prices & capabilities = PCB加工價格與能力
Flip all texts on bottom layer = 鏡像翻轉所有底層文字
Create New Document = 新建文檔
General Package = 常用封裝
General Packages = 常用封裝
favorite Package = 收藏封裝
Board Cutout = 槽孔
Surface Mount = 貼片
JLCPCB Part Class = 嘉立創庫類別
base = 基礎庫
expand = 擴展庫
recommend = 推薦庫
Basic Part = 基礎庫
Extended Part = 擴展庫
Recommended Part = 推薦庫
smtWeld = SMT貼片
thtWeld = THT波峰焊
manualWeld = 手工焊接
furnaceWeld = 爐前焊接
Multi-Layer = 多層
Markdown Syntax = Markdown語法
Markdown supported = 支持Markdown
Read only = 只讀
Read/Write = 讀寫
More Libraries... = 更多庫元件...
Decompress failed! = 解壓失敗！
Load failed! = 加載失敗
Loading = 加載中
No Result = 沒有結果

#Dialog Place Pin in schematic warning
Place Pin in schematic warning = 在原理圖放置引腳的注意事項
You can place a Pin in schematic, but don't forget to group all of the Pins to a schematic component, please click the help button to find out how to group them. If you just want to mark the wire, please use NetPort or NetLabel. = 可以在原理圖放置引腳，但別忘了要將引腳組合為原理圖符號，點擊幫助按鈕查看用法。如果只是標註導線，請使用網絡標籤。
I know. Do not show this again. = 我知道了，不要再提示該信息。

#Extensions Setting
Extensions Setting = 擴展配置
Remove = 移除
Disable = 禁用
Enable = 啟用
(Disabled) = (已禁用)
(Enabled) = (已啟用)
Load Extension = 加載擴展
Enable or disable will be applied after reload page = 啟用或禁用將在刷新頁面後生效
Your browser cannot run this function. = 您的瀏覽器無法運行該功能。
Your browser mode does not support indexedDB. Some features may not work properly. Are you using Private Browsing Mode? = 你的瀏覽器模式不支持indexedDB。一些功能可能無法正常工作。你是否在使用瀏覽器的隱身模式？
Extension Files = 擴展文件
Extension ID = 擴展ID
Select Files = 選擇文件

#Scripts
Script = 腳本
Scripts = 腳本
Script Content = 腳本內容
Load from js file = 從JS文件加載
UTF-8 encoded js file = UTF-8編碼的JS文件
Description = 描述
description=描述
Not a *.js file = 不是*.js文件
Failed to read file = 加載文件失敗
System scripts cannot be modified = 系統腳本不能被修改
Create Subfolder = 創建子目錄
Create Script = 創建腳本
Install Script = 安裝腳本
Install = 安裝
Desktop Client =
Are you sure you want to remove this script? = 確定要移除該腳本嗎？
Folder Name = 目錄名稱
Rename = 重命名
Please select a script = 請選擇一個腳本
Failed to load script = 加載腳本失敗
Run Script = 運行腳本
Load Script = 加載腳本
Title is required = 標題是必需的
Script content is required = 腳本內容是必需的
System Scripts = 系統腳本
User Scripts = 用戶腳本
You can right click on the tree nodes. = 你可以在樹節點上鼠標右擊。

#PCB photoView toolbar
Top Side = 頂面
Bottom Side = 底面
With Silk Layer = 有絲印層
No Silk Layer = 無絲印層
Photo View = 照片預覽

#check update
Check Update = 檢查更新
EasyEDA Editor {ver} is released. Would you like to switch to the new version now? = EasyEDA V{ver} 已發布，是否現在切換到新版本？
JLCEDA Editor {ver} is released. Would you like to switch to the new version now? = 嘉立創EDA V{ver} 已發布，是否現在切換到新版本？
Switch to New Version = 切換到新版本
Next Time = 下次再說

#download project dialog
Generating download link... = 正在生成下載鏈接...
Download project now = 點擊下載工程

#Import DXF
Import DXF = 導入DXF
Apply Unit = 應用單位
Convert circle to HOLE on BoardOutLine layer = 將邊框層的圓轉為孔
No shapes found = 無內容
Fail to load the file = 加載文件失敗
Please select a DXF file. = 請選擇DXF文件
This feature only works for PCB document. = 該功能僅能針對PCB文檔使用
Select a DXF file = 選擇DXF文件

#Export DXF
Export DXF = 導出DXF
Plated-Through-Hole Pads = 金屬化焊盤
Non-Plated-Through-Hole Pads = 非金屬化焊盤
Silkscreen = 絲印
Surface Pad = 表面焊盤

#Data Sync
Data Sync = 數據同步
Data Conflicts = 數據衝突
Project or Document = 工程或文檔
Cloud-Side = 雲端
Local-Side = 本地端
Decision = 決策
Modified = 已修改
Deleted = 已刪除
As Cloud = 按雲端
As Local = 按本地
Skip = 忽略
Data sync completed = 數據同步完成

#Team
Team = 團隊
Teams = 團隊
Switching team = 切換團隊
Switch team failed = 切換團隊失敗
Load team info fail! = 讀取團隊信息失敗
Load team info fail! Please reload. = 讀取團隊信息失敗，請刷新重試
My Teams = 我的團隊
Create Team = 新建團隊

#Dialog Footprint Manager
Footprint Manager = 封裝管理器
Open Footprint Manager = 打開封裝管理器
Schematic Components = 原理圖器件
Edit Pin Map Information = 編輯引腳映射
Package Categories = 封裝分類
Components List = 元件列表
Personal = 個人
Component PIN information = 元件引腳信息
Footprint PAD information = 封裝焊盤信息
Footprint Categories = 封裝分類
Pad Number = 焊盤編號
Search Footprint = 搜索封裝
Select Footprint =
Search 3D Model =
Select 3D Model =
Filter by keyword = 關鍵字篩選
System Libs = 系統庫

#dialog global delete
Drawings = 其他
Netlabel and netFlag = 網絡標籤和標識符
Texts = 文本
Wires = 導線
Board outlines = 邊框
Footprints = 封裝
Footprint = 封裝
Tracks = 導線

#dialog board outline settings
Current Size = 當前大小
Parameters = 參數
Start X: = 起始X:
Start Y: = 起始Y:
Round Rectangular = 圓角矩形
radius = 半徑
only number is allowed! = 只允許輸入數字！
please input valid value of width! = 請輸入有效的寬度值！
please input valid value of height! = 請輸入有效的高度值！
please input valid value of radius! = 請輸入有效的半徑值！

#cross probe
The object you selected was not found in other documents. = 其他文檔里沒有找到相應的元件。
No valid object for cross probe selected. = 沒有選中能進行交叉選中的元件。
Can not probe. Refreshing the window may get it to work. = 交叉選中失敗，刷新下試試。
You need to login for this function to work. = 登錄後才能使用此功能。

#About Dialog
An Easier EDA Experience = 高效的在線電子設計工具
Version = 版本
BuiltDate = 編譯日期

#Auto Router Dialog
Auto Router Config = 自動布線設置
General Options = 通用選項
All Layers = 所有層
Configure = 配置
Sorry, your web browser does not support this feature. Please run a modern browser. = 當前瀏覽器不支持該功能，請使用現代瀏覽器。
Please make sure all objects with net are inside the board outline! = 請確保全部有網絡的對象均在邊框內部！
Cannot start again before previous activity is stopped = 前一次布線未結束前不能再開始
Please select a net = 請選擇一個網絡
TrackWidth cannot be empty = 線寬不能為空
Clearance cannot be empty = 間距不能為空
Router is time out. = 布線超時
Server is busy, please try again later. = 服務器忙，請稍後重試
Due to the limitation of {0}router server{1} resources, multiple routers executing concurrently are not supported, please try again later or do it manually :-) = 受限於自動布線服務器資源，同時多任務布線不支持，請稍後重試。
Track Width is invalid = 線寬無效
General Clearance is invalid = 通用間隙無效
SMD Clearance is invalid = SMT間隙無效
Diameter is invalid = 直徑無效
Drill Diameter is invalid = 過孔內徑無效
Track width cannot be less than Design Rule Checking (DRC) setting value. = 走線寬度不能少於設計規則(DRC)的設定值。
General Clearance cannot be less than Design Rule Checking (DRC) setting value. = 通用間隙不能少於設計規則(DRC)的設定值。
SMD Clearance cannot be less than Design Rule Checking (DRC) setting value. = SMD間隙不能少於設計規則(DRC)的設定值。
Hole size cannot be less than Design Rule Checking (DRC) setting value. = 過孔直徑不能少於設計規則(DRC)的設定值。
Design Rule's via diameter must be larger than via drill diameter = 設計規則的過孔外徑必須大於孔內徑
Clearance cannot be less than Design Rule Checking (DRC) setting value. = 間隙不能少於設計規則(DRC)的設定值。
Not a valid PCB, please check it again = 無效的PCB，請重新檢查
Previous connection must be closed = 必須關閉先前的連接
Network error. Please try again. = 網絡錯誤，請稍後重試
Router error. = 布線錯誤
Invalid PCB. = 無效PCB
General Clearance = 通用間隙
SMD Clearance = SMD間隙
#Ripup Nets = 分割網絡
Skip Routed Nets = 忽略已布線的網絡
Remove Existing Tracks = 清除已有布線
Real-time Display = 實時顯示
Router Layers = 布線層
Via = 過孔
Special = 特殊
Special Nets = 特殊網絡
Skip Nets = 忽略網絡
Router Server = 布線服務器
Local = 本地
Cloud = 雲端
Available = 可用
Unavailable = 不可用
Checking = 檢測中
Install Local Auto Router = 安裝本地自動布線
Checking local auto router server... = 正在檢測本地布線服務...
Stop Router = 停止布線
Auto Router is running... = 自動布線運行中...

#Left Sidebar
Common Library = 基礎庫
Basic = 基礎
Extend = 擴展
Design Manager = 設計管理器
Library = 元件庫
Spice Library = 仿真庫
Shared = 共享
LCSC = 立創商城
LCSC Parts = 立創商城
Supply Flag = 電氣標識符
US = 美標樣式
EU/IEC = 歐標樣式
US Style = 美標樣式
Resistor = 電阻
Capacitor = 電容
Inductor = 電感
Switch/Key = 開關/按鍵
EU/IEC Style = 歐標樣式
CN = 國標樣式
Connector = 連接器
Switch/Relay = 開關/繼電器
JLCPCB = 嘉立創
Recycle Bin = 回收站

#Protractor
Font Height = 字體高度
Precision = 精度
Protractor = 量角器

#attr-pcbtext-line-width
Only default font family supports to change font width. = 僅默認字體支持修改字體寬度。
Font is missing! You can confirm the dialog and use default font instead or cancel the dialog then upload your font and do it again. = 字體缺失，請使用默認字體或添加該字體。

#Common
Owner = 所有者
License = 協議
Part Pins = 元件引腳
Part Properties =
Net Pins = 網絡引腳
Net Ratlines = 網絡飛線
Add Parameter = 添加新參數
Histories record = 歷史記錄
Create Team = 創建團隊
Can't find this footprint on the server, please re-associate it. = 服務器上未找到該封裝，請重新關聯。
The footprint name associated with the component and the footprint name on the server are inconsistent, please re-associate it. = 元件關聯的封裝名和服務器上的封裝名不一致，請重新關聯。
The symbol pin number(s) of the component does not match the associated footprint pad number(s), please modify the symbol pin number(s) or re-associate the footprint = 元件的符號引腳編號與關聯的封裝焊盤編號不匹配，請修改符號引腳編號或重新關聯封裝
No footprint, please associate the footprint first. = 沒有封裝，請先關聯封裝。
Can't find the package = 未找到封裝
The path is for the project URL identify, it is unique (the identity of the project owned by the user cannot be the same)=工程路徑用於工程url的後綴，路徑具有唯一性（用戶所擁有工程的路徑不能相同）
It's with a letter or a number and can contain only numbers, letters, line-through, underscores, and points. It cannot be modified after saving. = 路徑以字母或數字開頭，只能包含數字、字母、中劃線、下劃線及點，保存後不能修改
Updating document to new format, please wait......After finishing please save your document with Ctrl + S. = 正在更新文檔至新格式，請稍候......更新完成後請按Ctrl+S保存文件。
Open at current project? = 在當前工程打開？
Please select a history to recover. = 請選擇一個歷史記錄恢復。
Be careful! When you click the "Recover" button, this sheet will be overwritten! = 請注意！若你點擊了「恢復」按鈕後，該頁會被覆蓋！
Recover = 恢復
There is no PCB under this project, would you like to create one? = 工程下無PCB，是否創建一個？
Please make sure that the chose Altium Designer files are saved as ASCII files. = 請確保選擇的Altium Designer文件是另存為ASCII格式的文件。
Export to Altium function is currently in beta: = 導出Altium功能暫時在測試版：
1. Please be sure to read the notice before exporting:  = 1、導出前請務必閱讀：
Export Altium notice and disclaimer = 導出Altium注意事項與免責聲明
2. Please be sure to check again after export! = 2、導出後請務必再次檢查！
I have read and agree = 我已閱讀並同意
Export to Altium = 導出Altium
Please make sure that the chose Eagle files are saved in Eagle v6.0 and above. = 請確保選擇的Eagle文件是Eagle v6.0及以上版本保存的文件。
Please make sure that the Kicad files were compressed as the .zip file. = 請確保Kicad文件是壓縮在zip壓縮包文件中。
Open Altium Designer file =  打開Altium Designer文件
The more information please refer at : = 更多信息請查看：
Please use Gerber file instead of exporting Altium if you are going to do PCB manufacturing. All PCB factories support the Gerber file. Is it ok to Generate the Gerber file? = 如果你需要生產PCB，建議使用Gerber文件而不是導出Altium文件，板廠均支持使用Gerber生產PCB。是否生成Gerber？
Yes, Generate Gerber = 是，生成Gerber
No, Export Altium = 否，導出Altium
Open Eagle file = 打開Eagle文件
Open Kicad file = 打開Kicad文件
Select file(s) = 選擇文件
Append to current project? = 插入到當前工程？
Append = 插入
Open as new project = 打開為新工程
Tip: Press {0}SPACE{1} or {2}R{3} to rotate the placing object or selected object. = 提示：按 {0}空格鍵{1} 或 {2}R鍵{3} 旋轉待放置或選中的零件。
Hotkeys Setting = 快捷鍵設置
I know. Don't show this again. = 我知道，不再顯示該提示。
Manufacturer Part Number can not be less than 2 characters. = 製造商元件編號不能少於2個字符。
This prefix was changed to non-subpart format. = 編號已被修改為非子庫格式。
Save as New Project = 保存至新工程
Save to Existing Project = 保存至已有工程
Sheet Setting = 文檔設置
Sheet Size = 文檔尺寸
Pre = 編號
pre = 編號
Invalid Data = 數據格式不對
Others = 其它
You are not authorized to share this project. = 你無權限分享該工程。
This project is private: if you continue sharing it will be made public. = 該工程是私有工程，繼續分享將公開。
Modify file info = 修改文檔信息
Please input search keyword = 請輸入搜索關鍵詞
Sort Projects by = 工程排序
Date Created = 創建時間
Date Modified = 修改時間
Title = 標題
Ascending = 升序
Descending = 降序
Pin to Top = 置頂
Unpin from Top = 取消置頂
Collapse / Expand = 摺疊 / 展開
Expand = 展開
Expand All = 全部展開
Collapse = 摺疊
Collapse All = 全部摺疊
Your file hasn't been saved, do you want to save it? = 你的文件尚未保存，是否保存？
Don't Save = 不保存
Library Owner: = 庫所有者：
verifyPkg.Value = 名稱
State = 狀態
Please select! = 請選擇！
Route = 布線
Import successfully: = 導入成功：
Import failed: = 導入失敗：
Path only contain 'a-z、A-Z、- 、 _ 、0-9'! = 路徑只能包含'a-z、A-Z、- 、_ 、0-9'！
Path must begin as 'a-z、A-Z、0-9'! = 路徑必須以'a-z、A-Z、0-9'開頭！
The path length must be between 4~128 characters! = 路徑長度必須為4~128字節！
The title length must be between 2 ~ 128 characters. = 標題長度必須為2~128字符.
Please select an owner =
Please select obj, wrl or zip file. =
Do you want to delete this file? = 你確認你需要刪除該文件嗎？
Add sub part success = 添加子庫成功
Please input name and prefix! = 請輸入編號和名稱
Board outlines are not closed = 板子邊框沒有閉合
Import failed! The imported files were not ASCII format, please save the files as "Advanced Schematic ascii(*.SchDoc)" or"PCB ASCII File(*.PcbDoc)" at Altium Designer first, and then import. =
The Pins "{0}" are not snapped on the grid point! This part maybe will cause some errors in the schematic. = 引腳「{0}」沒有吸附在格點上！這個庫在原理圖里可能會產生錯誤。
Save failed! Pin number doesn't allow repeat! As below pin number repeat: {0} = 保存失敗！引腳編號不允許重複！以下引腳編號重複：{0}
Check Pin = 引腳檢測
Failed to read {0} = 加載{0}失敗
{0} is invalid = {0}不可用
{0} not found = {0}不存在
Failed to execute script: = 執行腳本失敗：
One or more js files not found = 一個或多個js未找到
Only ONE {0} file is required = 只有{0}一個文件
Extension ID is required = 擴展ID不能為空
Extension ID is invalid = 擴展ID不合法
Extension ID is duplicated = 擴展ID已存在
No Result! = 無結果！
Load Error = 加載失敗
loading = 正在加載
Failed to load spice data = 加載仿真數據失敗
Netlist = 網表
Tags = 標籤
Pin Information: = 引腳信息：
Format incorrect, please check for the extra spaces or commas! = 格式錯誤，請檢查是否有多餘的空格或逗號！
Round Radius = 圓角半徑
Keyword: = 關鍵詞：
Image = 圖片
Image copied. = 圖像已複製
Copy failed. = 複製失敗
Copy success. = 複製成功
Image Property = 圖片屬性
Locked = 鎖定
Unlock All = 解鎖全部
Unlock = 解鎖
Lock = 鎖定
Please input pin name and pin number! = 請輸入引腳名稱和引腳編號！
Left-Hand Panel = 左側欄
Right-Hand Panel = 右側欄
Update Components from Library = 從元件庫更新元件
The pin number(s) can't find the same pad number(s) = 引腳編號未找到相同焊盤編號
Designator = 編號
Replace = 替換
Update failed = 更新失敗
Successfully updated = 更新成功
Update failed! = 更新失敗！
Successfully updated! = 更新成功！
Successfully updated {0} component(s)! = 成功更新 {0} 個元件！
Change = 變更
Check Footprints = 檢查封裝
Network Error! = 網絡錯誤！
Find Similar Objects = 查找相似對象
Current Sheet = 當前頁面
All Sheets = 全部頁面
Kind = 種類
Range = 範圍
Net Label/Net Flag/Net Port/Voltage Probe = 網絡標籤/標識符/網絡端口/電壓探針
Bezier/Freehand Draw = 貝塞爾曲線/自由繪製
Arc/Pie = 圓弧/餅形
Objects Properties = 多對象屬性
Any = 任意
Same = 相等
Different = 不等
Circular= 圓形
Expose Copper = 創建開窗區
"{0}" font is missing. Please add the font to the font family list. = "{0}"字體丟失，請添加該字體。
Place Component = 放置元件
Delete Segment = 刪除線段
Angle = 角度
Board Thickness = 板厚
Layer Distance = 層距
Silk Screen = 絲印顏色
Surface Finish Color = 焊盤噴鍍
Colors = 顏色
Board Color = 板子顏色
Board Side = 板面
Silk Screen = 絲印
Silk Screen Color = 絲印顏色
Display = 顯示

# Array and Clone
Distribute Array = 陣列分布
Array Type = 陣列類型
Matrix Array = 矩形陣列
Circular Array = 圓形陣列
Item Rotation = 元素旋轉角度
Location = 位置
Items per Column = 每列數量
Items per Row = 每行數量
# Column Spacing = 列距
# Row Spacing = 行距
Spacing(Degrees) = 間隔(角度)
Start Degree = 起始角度
Rotate Item to Match = 旋轉對象以適合圓形
Clockwise = 順時針
Anti-Clockwise = 逆時針
Distribute by = 分布類型
Column = 列
Row = 行
Array Clone = 陣列副本
Number of Rows = 行數
Number of Columns = 列數
Number of Copies = 副本數量
Distribute Range(Degrees) = 分布範圍(跨度)

# Theme color dialog
BusEntry = 總線分支
Foreground = 前景色
Common Used = 常用
Original Theme = 原始主題
Theme Setting = 主題設置
Change the theme colors of your design = 修改設計圖的主題顏色。
White on Black = 黑底白圖
Black on White = 白底黑圖
Custom Theme = 自定義主題
Color Setting = 顏色配置
Apply Setting = 應用設置
Theme Setting... = 主題設置...
Bus Entry = 總線分支
Symbol Graphics = 元件圖形
Common Used = 常用
Draw = 繪圖
Sheet = 表格
The original theme only works for placing the new symbols. = 原始主題僅對新放置的符號有效。
Selection Highlight = 選擇高亮
Net Label / Port = 網絡標籤 / 端口

My Theme = 我的主題
My Theme Settings = 我的主題設置
Apply 'Custom Theme' On = 在以下情形應用 「自定義主題」
Creating New Schematic = 創建新的原理圖
Opening Existed Schematic = 打開已存在的原理圖
Please fill in all parameters! = 請填寫全部參數
Convert to Board Cutout = 轉換成槽孔
Prefix Position = 編號位置
Name Position = 名稱位置
Center = 中間
Top = 上邊
Bottom = 下邊
Left = 左邊
Right = 右邊
Does not support multiple objects to convert to Board Cutout at the same time = 不支持多對象同時轉為槽孔
Does not support multiple objects to convert to pad at the same time = 不支持多對象同時轉為焊盤
Convert to Board Cutout = 轉為槽孔
Convert to Pad = 轉為焊盤
Convert to Component Shape = 轉為元件外形
Combine to Continuous Track = 合併為連續導線
Convert to Solid Region = 轉為實心填充
Substrate = 基板
3D View = 3D預覽
2D View = 2D預覽
Pin Color = 引腳顏色
Name Color = 名稱顏色
Number Color = 編號顏色
Dot = 圓圈

[theme]
Sheet = 表格
[/theme]


#history dialog
[history-dlg]
Number = 編號
Editor = 編輯者
[/history-dlg]
View File History = 歷史記錄
Save Time = 保存時間

Invalid Format = 格式錯誤

#Dialog Teardrop
Round Pad / Via = 圓形焊盤 / 過孔
Rectangle / Oval / Polygon Pad = 矩形 / 橢圓 / 多邊形焊盤
Applying Teardrops = 正在應用淚滴
Removing Teardrops = 正在移除淚滴
Waiting = 請等待
Progressing... = 執行中...

No schematic in the project! = 工程內無原理圖！

Move Forward = 前移
Move Backward = 後移

#Dialog Panelize
V-CUT = V割
Stamp Hole = 郵票孔
No Panelize = 不拼板
Border and Marking = 邊界與標記
Create Border = 創建邊界
Border Height = 邊界高度
Border Position = 邊界位置
Create Positioning Holes = 創建定位孔
Create Fiducial Marks = 創建定位點
Top and Bottom = 頂部和底部
Left and Right = 左邊和右邊
Stamp Hole Group - Column = 郵票孔組數 - 列
Stamp Hole Group - Row = 郵票孔組數 - 行
The number of rows and columns cannot be set to 1 simultaneously = 行數或列數不能同時設置為1
When panelize number is 1 x 1, you need to enable the "Create Boarder" =

#edit path point
[editPathPoints-dlg]
Arc(R) = 圓弧半徑
Type = 圓弧類型
Action = 操作
add before = 在前面添加一行
add after = 在後面添加一行
delete = 刪除
[/editPathPoints-dlg]

#edit polygon point
[editPolygonPoints-dlg]
Action = 操作
add before = 在前面添加一行
add after = 在後面添加一行
delete = 刪除
[/editPolygonPoints-dlg]
You have unconfirmed edit! = 你還沒有完成編輯！
Invalid edit! = 你所編輯的點不符合規則！

#Dialog PCB Information
PCB Information... = PCB信息...
Signal Layers = 信號層
None Signal Layers = 非信號層
Pads = 焊盤
Surface Pads = 單層焊盤
Plated Through-hole Pads = 金屬化焊盤
None Plated Through-hole Pads = 非金屬化焊盤
Holes = 孔
Vias = 過孔
Length of Tracks = 導線長度
Copper Areas = 鋪銅數量

#Differential Pair Routing
Differential Pair Routing = 差分對布線
Differential Pair Rule Setting = 差分對布線規則
Please input track width = 請輸入線寬
Please input clearance = 請輸入間距
Routing Rules = 布線規則

#Route Length Tuning
Track Length Tuning... = 線長調整...
Tracks with different net or non-track found in current targets. = 當前目標中存在不同網絡的導線或非導線。
Please select the signal tracks to be tuning. = 請選擇要調整的信號層導線。
The total length exceeds the Design Rule Checking (DRC) constraint, continue ? = 總長度超過了設計規則(DRC)限制，是否繼續？
45° Angle = 45° 角
90° Angle = 90°角
DRC Track Length : = DRC導線長度 :
Current Length : = 當前長度 :
Additional Length : = 要增加的長度 :
Target Length: = 目標長度:
Current Length: = 當前長度:
Adjust Type = 調整類型
Double Side = 雙邊
Single Side = 單邊

can not connect to the server = 無法連接服務器

#Dialog Copper Area Manager
Copper Area Manager... = 鋪銅管理器...
Copper Area Manager = 鋪銅管理器
Order = 序號
Name = 名稱
Layer = 層
Color = 顏色
Net = 網絡
Move Up = 上移
Move Down = 下移
Apply = 應用
Cancel = 取消
Copper Area do not allow self-intersection! = 鋪銅不允許自相交！
No copper area! = 無鋪銅！
#Dialog report error
Datasheet = 規格書
Verification = 審核
Symbol = 符號
Pad Number = 焊盤編號
Pad Size = 焊盤尺寸
Remark= 備註
Correct = 正確
Incorrect = 錯誤
Submit = 提交
Tip = 提示
Please select one component = 請選擇一個元件
Location X = X 坐標
Location Y = Y 坐標
Your current browser version may not support some features. Please use the latest version of Chrome or Firefox, or try the desktop client. = 您當前的瀏覽器版本可能不支持某些功能。請使用最新的谷歌或者火狐瀏覽器，或使用客戶端。
EasyEDA Client = EasyEDA客戶端
JLCEDA Client = 嘉立創EDA客戶端
Chrome = 谷歌瀏覽器
FireFox = 火狐瀏覽器
New Version = 新建版本
Switch Version = 切換版本
Members = 成員
Update Time = 更新時間
Editor = 編輯者
Current Version = 當前版本
Latest Version = 最新版本
Please select a different version to switch; If you want to edit different version in the same time, please open them in different browsers. =
3D Model = 3D庫
Board Side = 板面
Display = 顯示
Copper = 銅色
Create New Version = 創建新版本
Create new version success! = 新版本創建成功！
Version Management = 版本管理
Switch success! = 切換成功！
Please close current version's documents first! = 請先關閉當前版本的所有文檔！
Creator = 創建者
creator =
Create Time = 創建時間
Fail to connect to server! Please check your internet connection status and try again! = 連接服務器失敗！請檢查你的聯網狀態並再次嘗試！
Spice Number = 仿真編號
Create = 創建
3D Outline = 3D體形線
Cannot create the slot hole via the board outline, please use the following methods: = 不支持邊框挖槽，挖槽方法請參考下方：
Use the solid region and set its type as Board Cutout = 直接使用實心填充的槽孔
Select a Track/Arc, right-click to use the "Convert to Board Cutout" = 選中導線或圓弧，右鍵選擇「轉為槽孔」
Select all the closed Tracks/Arcs, right-click to use the "Convert to Board Cutout" = 全選閉合的導線或圓弧框，右鍵選擇「轉為槽孔」
The more information please refer at = 更多信息請查看
Save "{0}" success! = 保存 "{0}" 成功！
Save "{0}" failed! = 保存 "{0}" 失敗！
Invalid Size = 非法尺寸
Processing = 處理
NetFlag GND = 標識符GND
NetFlag VCC = 標識符VCC
NetFlag +5v = 標識符+5v
No Useful Data! = 無可用數據！
SVG Preview = SVG預覽
Prefix contains not supported charater(s) ! = 編號包含了不支持的字符！
Name contains not supported charater(s) ! = 名稱包含了不支持的字符！
Create Grid Path = 生成網格路徑
Please Input Name = 請輸入名稱
Building Copper Area = 正在鋪銅
Processing = 處理中
Opening File = 正在打開文件
Update from Library = 從庫里更新
Update Footprint = 更新封裝
Update 3D Model =
Find footprint(s) have been updated, do you want to update? = 發現一些封裝有更新，是否更新？
3D File: = 3D文件
Model List = 模型列表
Are you sure merge net {0} and net {1}? = 你確定合併網絡 {0} 和網絡 {1} 嗎？
Display Footprint = 顯示封裝
Display Footprint Name While Placing Component = 放置元件顯示封裝名
Annotate Prefix Automatically After Placing Component = 放置元件自動編號
Program Error, Please Contact Technical Support! = 程序錯誤，請聯繫技術支持。
Search Engine = 搜索引擎
Keyword to Filter = 輸入關鍵字過濾
Normal Mode = 精簡模式
Expand Mode = 放大模式
3D Model Manager = 3D模型管理器
3D Model Preview = 3D模型預覽
3D Model = 3D模型
3DModel = 3D模型
Document = 文檔

[pcblayer]
3DModel = 3D模型層
Document = 文檔層
[/pcblayer]

Adjustment = 校準
View Larger Image = 點擊查看大圖
Previous = 上一步
Previous Image = 上一組圖片
Next Image = 下一組圖片
Notice: For reference only, please refer to the real product = 溫馨提醒：圖片僅供參考，商品以實物為準
It's under designing, please wait. = 正在設計中，敬請期待。
The width of track/arc/circle cannot be less than 0.1mil! = 導線/圓弧/圓的線寬不能小於0.1mil！
Clone success ! = 克隆成功！
Footprint Naming Reference = 封裝命名參考
3D Model Manager = 3D模型管理器
Will jump to the Lichuang open source hardware platform (OSHWHub.com) to improve the information and share. Whether to continue? = 將跳轉到立創開源硬件平台(OSHWHub.com)完善信息後進行分享。是否繼續？
Will jump to the EasyEDA open source hardware platform (OSHWLab.com) to improve the information and share. Whether to continue? = 將跳轉到EasyEDA開源硬件平台(OSHWLab.com)完善信息後進行分享。是否繼續？
The project content page will open. After adding a description and setting the project to public, you can click the share button to get the share link. = 將打開工程內容頁面，你可以補充描述和把工程設置為公開後，再點擊分享按鈕獲取分享鏈接。
This project is not public, can not view homepage! = 工程沒有公開，無法查看工程主頁！

[grid]
None = 無填充
[/grid]

#lib verify and mounted
This component is verified = 元件已經驗證
This component is unmounted = 元件不上件

#find component
Find Next = 下一個
Pin not found =
Pad not found =
Object not found = 沒有找到相應元件

#offset Elements
Offset X = 偏移X
Offset Y = 偏移Y
Offset = 偏移
Absolute Offset = 絕對偏移
Relative Offset = 相對偏移
Absolute Offset... = 絕對偏移...
Relative Offset... = 相對偏移...
Reference Point X = 參考點X
Reference Point Y = 參考點Y

# Inner Plane layer
Rebuild Plane = 重建內電層
PlaneZone Properties = 內電層屬性
Change to a plane layer is not allowed during track routing. = 在布線時不允許將導線切換到內電層。
#pcblib rect
Fill = 填充
Fill Type = 填充類型
[PlaneZone]
Solid = 填充
[/PlaneZone]

Solid Region do not allow self-intersection! = 實心填充不允許自相交！

The prefix or name or text too far away from the footprint, if you don't want it to show up please make it hidden. =  編號或名稱或文本距離封裝太遠，如果不想讓它顯示請隱藏它。
The prefixes are not allowed to repeat! = 編號不允許重複！
Save failed! The origin of the canvas is not in the graphics! Whether to set the origin automatically? = 保存失敗！畫布原點沒有在圖形內部！是否自動設置原點？
The origin of the canvas has been set in the graphics now, you can save again. = 畫布原點已設在圖形內部，你可以再次保存
Backup Project = 備份工程
Open Project Directory = 打開工程目錄

{0} items updated = {0} 個元件已更新

The current file {0} has an updated version. Do you want to overwrite it? If you want to open the latest version, please close the current file and reopen it. = 當前文件 {0} 存在更新的版本，是否進行覆蓋？如需打開最新版本，請關閉當前文件再重新打開。
Yes, Overwrite It = 是，覆蓋
No, Keep It = 否，保留

Download Client = 下載客戶端

Search tutorial、open source projects etc. = 搜索教程、開源工程等

Go to LCSC and search for = 去立創商城搜索
Go to LCSC = 去立創商城

Hide Ratline Layer and Keep the Component Prefix When Paste Objects = 當粘貼元素時隱藏飛線層並保持元件編號不變

ALL.layer = 全部層
Copper.layer = 銅箔層
Non-Copper.layer = 非銅箔層
Other.layer = 其他層

Please enter at least 2 characters! = 請輸入至少2個字符！
View Datasheet = 查看規格書
View Datasheet... = 查看規格書...

The corresponding package or network could not be found in the currently open PCB document = 當前打開的PCB文檔中找不到相應的封裝或網絡
delete fail = 刪除失敗

[crashRecovery]
Libraries = 庫文件
[/crashRecovery]
Canvas origin anomaly! = 畫布原點異常

Component's Name = 元件名稱
Component's Prefix = 元件編號
Component's Footprint = 元件封裝

[findlib]
Clear = 清除篩選
Apply Filters = 應用篩選
Result= 篩選結果
Place = 放置在畫布
Prev = 上一頁
Next = 下一頁
Total {count} Count = 共{count}條記錄
About = 約
Items = 條結果
Apply New Part =
No Part Yet =
[/findlib]

Object = 元素
Layers and Objects = 層與元素
All = 全部

Add custom = 新增自定義

Connections = 連接
Attempted: = 全部:
Completed: = 已完成:
Failed: = 失敗:
Total Vias: = 過孔數:

Please confirm moving option = 請確認移動方式
Only this pad = 僅移動焊盤
For this component = 移動整個元件
View Owner = 查看所有者
View Detail = 查看詳情


# place batch vias
Place Vias = 放置過孔
Placing Vias = 正在放置過孔
Removing Vias = 正在移除過孔
Batch Vias for Copper = 鋪銅批量過孔
Add/Remove Vias = 添加/移除過孔
Diameter = 直徑
Drill Diameter = 過孔內徑
Column Spacing = 列距
Row Spacing = 行距
Multiple vias have been placed, do you want to rebuild the copper area? = 批量放置過孔已經完成。是否重建鋪銅？
Remove vias finish, do you want to rebuild the copper area? = 批量移除過孔已經完成。是否重建鋪銅？
The width of track/arc/circle cannot be less than 0.051mm/2mil/0.002inch! = 導線/圓弧/圓的線寬不能小於0.051mm/2mil/0.0002inch！
Save fail! Please try again! = 保存失敗！請重試！
Please select a copper outline = 請選擇鋪銅邊框
Can't find copper area at other layers, please add the copper area with the same net at other layer first. = 未找到其它層的鋪銅，請先在其他層繪製相同網絡的鋪銅。

Add favorite success! = 收藏成功！
Remove favorite success! = 取消收藏成功！
Remove favorite failed! = 取消收藏失敗！
Whether if remove favorite? = 是否取消收藏?
Split by ';' for multi tags = 用分號分隔多個標籤

This size is the determined size! = 這個尺寸是已經確定的尺寸！
The associated pad has been locked = 相關聯的焊盤已被鎖定
Split by space or , for multi tags = 用空格或逗號分隔多個標籤

Rotation X = X軸旋轉
Rotation Y = Y軸旋轉
Rotation Z = Z軸旋轉

Some fields are filled invalid data = 某些字段填充了無效數據
start time should be earlier than stop time = 起始時間應小於結束時間
Number of points should be less than 100 in octave variation = octave類型變化中的點數應小於100
Start frequency should be less than stop frequency. The suffix meg stands for Mega,m stands for milli = 起始頻率應小於停止頻率。後綴meg代表Mega，m代表milli
Get historical records fail! = 獲取歷史記錄失敗！
This 3D model didn't create the outlines successfully, please import it again or contact with us. = 這個 3D 模型的外形數據沒有創建成功，請再次導入或者聯繫我們。
There is No Tag! = 沒有分類！
Assign successful! = 分配成功！
Found footprint's pad number doesn't match the schematic component's pin number, please correct the pad number and try again! = 發現封裝焊盤編號不匹配原理圖器件的引腳編號，請手動修正焊盤編號後再重試！
Update Property = 更新屬性
Update Properties =
Please fill in at least 5 words. = 請至少填寫 5 個字。
Mouse hovering over the track to highlight the entire network = 鼠標懸浮在導線上高亮整個網絡
Net Highlighting While Cursor Hover the Track = 鼠標在導線上時高亮網絡
When circle set as "Yes", the Pin length must be more than 6 = 當圓圈設置為「是」時，引腳長度需要大於 6
Hi, I found a problem of your library, this library seems incorrect.\ntitle:{title}\nType:{type}\nlink:{link}\n{content}\nThank you! = 你好，我發現了你的一個庫可能存在錯誤。\n標題：{title}\n類型：{type}\n鏈接：{link}\n{content}\n謝謝！

Logout fail! Please try again! = 退出登錄失敗！請再次嘗試！
Logout success! We look forward you to use JLCEDA again! = 退出成功！期待您再次使用嘉立創EDA！
Logout success! We look forward you to use EasyEDA again! = 退出成功！期待您再次使用EasyEDA！
Click to Preview 3D = 點擊預覽3D
[logoutDialog]
Logout = 退出登錄
[/logoutDialog]

[findlibTag]
All = 全部
[/findlibTag]

Export Pick and Place File = 導出坐標文件
Mirror the bottom components' coordinate (JLCPCB doesn't need) = 鏡像底層元件X坐標(嘉立創不需要)
Mirror coordinate Y =
Mirror coordinate X =
Work Space = 工作區
Include panelized components' coordinates(JLCPCB doesn't need) = 包含拼板後的元件坐標
Personal Workspace = 個人工作區
Work Space - {name} = 工作區 - {name}
Work Space - Personal = 工作區 - 個人
Cloning = 克隆中

Project Owner = 工程所屬
Clone Project = 克隆工程
Homepage = 個人主頁
Apply for Education Edition = 申請教育版
Load Organization failed = 加載組織失敗
Joined = 我參與的
Favorite = 我收藏的
This operation will unfavorite this project, do you want to continue? = 此操作將取消收藏該工程，是否繼續？
View Homepage = 查看主頁
Private Project = 私有工程
3-7 days = 3-7 天
Close Tab = 關閉標籤
Close Other Tabs = 關閉其他標籤
Close All Tabs = 關閉所有標籤
Open in New Window = 在新窗口打開
Cursor Snap to Component's Origin or Pad Center While Dragging Component = 移動元件時光標吸附到元件原點或焊盤中心
Undefined = 未定義
Input = 輸入
Model Unit = 模型單位
File Unit = 文件單位
This part contains subparts, please make sure you have checked other subparts before reporting error, do you want to continue? = 這個庫含有多個子庫，報錯前請確保已經檢測其他子庫，是否繼續？

[saveAs]
Power = 電源
[/saveAs]

Assign LCSC Part# = 分配立創編號
Unexpected error while converting. Perhaps unsupported file type or program bug. = 轉換時出現意外錯誤。可能是不支持的文件類型或程序錯誤
Found duplicated component IDs, please click "OK" to re-assign component ID automatically, and then save the document and try again. = 發現重複的器件ID，請點擊「確認」後重新自動分配器件ID，並保存文檔，再次重試。

Format = 格式
View = 視圖
Design = 設計
Simulation = 仿真
Advanced = 高級
Fabrication = 製造
Check DRC = 檢查DRC
Simulation Setting = 仿真設置
BOM = 物料清單(BOM)
PCB Fabrication File(Gerber) = PCB制板文件(Gerber)
Pick and Place File = 坐標文件
Parts Order = 元件購買
PCB Order = PCB下單
One-click Order Parts =
One-click Order PCB/SMT =
JLCPCB Layout Service =
SIM = 仿真
STD = 標準
WaveForm = 波形

Place Module = 放置模塊
Please enter identification letters: = 請輸入標識字母：
Only support English letters, up to 5. = 僅支持英文字母，最多 5 個。

Exist doesn't annotate prefix component(s) in the module, please edit and annotate the unique prefix(s) for component(s) first. = 模塊裡面存在未編號的元件，請先分配一個唯一的編號給元件，再進行放置。
Opening = 正在打開

Also update track's net (Only applies to circumstance under which prefix/netlabel changes and no component/wire is added or removed) = 同時更新導線的網絡(只適用於元件編號或網絡標籤變更的場景，不適用於元件或導線增刪的場景)

# desktop client error feedback
Cannot open online documents on Project Offline mode. = 工程離線版模式下不支持打開在線工程！

Please select a project = 請選擇一個工程
Opened Projects = 已打開工程
Open Project= 打開工程
Close Project = 關閉工程
Open All Projects = 打開所有工程
Close All Projects = 關閉所有工程
Select Owner = 選擇所有者
Select Folder = 選擇文件夾
Select Owner or Folder = 選擇所有者或文件夾
Select Project = 選擇工程
Folder = 文件夾
New Folder = 新建文件夾
New Sub Folder = 新建子文件夾
Delete Folder = 刪除文件夾
Move Project = 移動工程
Move Folder = 移動文件夾
# Rename Folder = 重命名文件夾
Please input the folder name = 請輸入文件夾名稱
Invalid folder name = 無效的文件夾名稱
Are you sure to delete this folder? = 確定要刪除該文件夾嗎？
All projects in this folder will be moved to the root directory. =
Create new folder successfully = 新建文件夾成功
Failed to create new folder = 新建文件夾失敗
Delete folder successfully = 刪除文件夾成功
Failed to delete folder = 刪除文件夾失敗
Rename folder successfully = 重命名文件夾成功
Failed to rename folder = 重命名文件夾失敗
Move folder successfully = 移動文件夾成功
Failed to move folder = 移動文件夾失敗
Move project successfully = 移動工程成功
Failed to move project = 移動工程失敗
The folder depth must not exceed {0} levels = 文件夾深度不得超過{0}層
Failed to add project to folder = 添加工程到文件夾失敗

Doesn't support SMT = 不支持嘉立創貼片
JLCPCB SMT Stock: {0} = 嘉立創貼片庫存 {0}

Reset failed! There are duplicate component prefixes in the current schematic: = 重置失敗！當前原理圖存在重複的元件編號：
Reset failed! There are duplicate component prefixes in the current PCB: = 重置失敗！當前PCB存在重複的元件編號：
Please modify the component prefixes first to ensure that the component prefix is unique. = 請先修改編號確保元件編號是唯一的。

JLCEDA(YALONG Edition) - A Simple and Powerful Electronic Circuit Design Tool =
JLCEDA(Standard) - A Simple and Powerful Electronic Circuit Design Tool = 嘉立創EDA(標準版) - 免費、易用、強大的在線電路設計軟件
EasyEDA(Standard) - A Simple and Powerful Electronic Circuit Design Tool = EasyEDA(標準版) - 免費、易用、強大的在線電路設計軟件

#Dialog for Package Custom Data
Please input the data title = 請輸入數據標題
Data title duplicated = 數據標題重複
Cannot be more than {0} characters! = 不能超過 {0} 個字符！
Only latin alphabets, digits, underscore(_) and hyphen(-) are allowed. = 僅限使用英文字母、數字、下劃線(_)、短橫線(-)。
Invalid value of item {0} = {0} 項的值無效
Update DFM = 更新DFM
Custom DFM Data = 自定義DFM數據
Saved custom data successfully! = 保存自定義數據成功
Save custom data failed! = 保存自定義數據失敗
Will replace the graphics and custom data of current document, after imported please adjust the 3D model. Continue or not? = 將替換當前文檔的全部圖形和自定義數據，導入後請重新調整3D模型。是否繼續？
Open footprint "Custom Data" dialog = 打開封裝自定義數據對話框

# Create lead shape
Create Lead Shape = 創建引腳外形
Base on Pad Center = 基於焊盤中心
Base on Canvas Origin = 基於畫布原點
Lead shape = 引腳外形
Footprint Type = 封裝類型
From pad shape = 從焊盤外形
Lead length = 引腳長度
Lead width = 引腳寬度
Lead diameter = 引腳直徑
Scaling ratio = 縮放比例
Leads creating direction = 引腳創建方向
Auto = 自動
Horizontal = 橫向
Vertical = 縱向
Canvas origin to lead edge = 畫布原點到引腳邊界
Canvas origin to body edge = 畫布原點到外形邊界
Lead soldering length = 引腳焊接長度
Lead soldering part diameter = 引腳焊接部分的直徑
Component shape object doesn't overlap lead shape object, please check carefully. = 元件外形層與引腳外形層(懸空或焊接部分)圖元沒有進行相交重疊，請仔細檢查。
The solder mask expansion of pads ({0},{1}) has a small clearance(less than 0.08mm), it will cause the soldering too short, please modify. = 焊盤 ({0},{1}) 阻焊擴展或自定義阻焊層圖元間距小於 0.08mm，將導致連錫，請修改。
The paste mask expansion or custom paste mask layer objects of pads ({0},{1}) has a small clearance(less than 0.15mm), it will cause the stencil to create fail, please modify. = 焊盤 ({0},{1}) 助焊擴展或自定義錫膏層圖元間距小於 0.15mm，將導致無法正常開鋼網，請修改。
System footprint must have pad number 1 or A1, please modify the pad number. = 系統封裝必須存在焊盤編號是 1 或者 A1 的焊盤，請修改焊盤編號。
System footprint doesn't allow two or more pad numbers are 1 or A1, please modify the pad number. = 系統封裝不允許出現兩個及以上焊盤編號是 1 或者 A1 的焊盤，請修改焊盤編號。
Document layer has circle object, but jlcPara's polarity is 0, please check the Custom Data. = 封裝文檔層存在圓，但 jlcPara 的 polarity 是 0，請注意檢查自定義數據。
There are exist repeat pad numbers: {padNumber}, please check, if it is correct please ignore this. = 焊盤編號存在重複: {padNumber}，請檢查是否正常，如果正常請忽略該提示。
Can't find the circle at the component marking layer, or this circle doesn't at the same quadrant with the 1st pad, please check whether it is correct. = 封裝沒有繪製元件極性層的圓形，或者標識層的圓和第一腳焊盤不在相同象限，請檢查是否正常。
This footprint is LED, CASE or DIO type, please check if need to draw the polarity marking(or special polarity marking), if exits polarity marking please ignore this message. =
This footprint is DIP type, please check if haven't place multi-layer pads. =
This footprint is SMD type, please check if haven't placed single-layer pads. =

ROUND = 圓形
RECTANGLE = 矩形
OCTAGONAL = 長圓形
Upper left = 左上
Lower left = 左下
Center of Pads = 焊盤中央
First Pin = 第一引腳
Package Name = 封裝名
Pins Number = 引腳數量
Rows Of Pin = 引腳行數
Columns Of Pin = 引腳列數
Polarity = 極性
Pad Shape = 焊盤形狀
Body Diameter = 本體直徑
Lead Span = 引腳跨距
Lead Vertical Span = 引腳縱向跨距
Body Length = 本體長度
Body Width = 本體寬度
Pin Diameter = 引腳直徑
Pin Length = 引腳長度
Pin Height = 引腳寬度
Pin Solid Width = 引腳焊接長度
Pin Solid Height = 引腳焊接寬度
Pin Spacing = 引腳間距
Pin Horizontal Spacing = 引腳橫向間距
Pin Vertical Spacing = 引腳縱向間距
ThermalPad = 熱焊盤
Pad Expansion = 焊盤擴展
Custom PasteMask = 自定義錫膏層
Fabrication Tolerance = 製造容差
Placement Tolerance = 放置容差
FirstPin Position = 第一引腳位置
Package Origin = 封裝原點
Expansion Size = 擴展尺寸
Corner = 拐角
Angle = 直角
Fillet = 圓角
Chamfer = 倒角
Update Preview = 更新預覽
Number of pins (left and right) = 引腳數(左右)
Number of pins (up and down) = 引腳數(上下)
Reference Use Cases = 參考用例
Package Type = 封裝類型
Capacitance = 電容
Resistance = 電阻
Bidirectional Diode = 雙向二極管
Inductance = 電感
Crystal Oscillator = 晶振
Diode = 二極管
LED = 發光二極管
Fuse = 保險絲
Entity height = 實體高度
Lead Overhang = 引腳懸垂長度
Lead Thickness = 引腳厚度
Unknown mistake = 未知錯誤
Has ThermalVias = 散熱過孔
Polar Capacitance = 極性電容

Create Component Marking = 生成元件標識
Create component marking successfully! = 創建元件標識成功！
No elements on component shape layer! = 元件外形層沒有圖元！
No elements on lead shape layer! = 引腳外形層沒有圖元！
No pad of number 1 or A1, please modify the pad number. = 焊盤編號是 1 或者 A1 的焊盤，請修改焊盤編號。
Save failed! Component marking circle is at the axis. Do you want to recreate the component marking? = 保存失敗！元件標識層的圓在坐標軸上，是否重新生成元件標識？
If autoroute fail, you can export the autoroute file(DSN) to third-party autorouter tool(Such as: FreeRouting, Konekt Electra, Eremex TopoR etc.), and export the session file(SES) after finished autoroute, and then import to PCB. = 如果自動布線失敗，你可以導出自動布線文件(DSN)到第三方布線工具(如 FreeRouting、Konekt Electra、Eremex TopoR等)，完成自動布線後導出會話文件(SES)，再導入PCB。
Auto route failed! Found abnormal pad(s) data, please modify the pad width and height: = 自動布線失敗！發現異常焊盤數據異常，請手動重新調整焊盤寬高：
Select Properties = 選擇屬性
Combine the same parts' prefixes in one row = 合併相同元件的編號在同一行
Please check at least one item! = 請至少勾選一項!
Pins = 引腳數
Check component latest version when open schematic = 當打開原理圖時檢測元件最新版本
Only show updated components =
Note: When a PCB is Import Changes, the PCB is updated according to the footprint version to which the schematic is bound. = 注意：當 PCB 導入變更時會根據原理圖綁定的封裝版本進行更新 PCB。
Doesn't support to import the binary format DXF, please import the ASCII format DXF. = 不支持二進制的 DXF 導入，請導入 ASCII 格式的 DXF

Find System Similar Footprint = 查找系統相似封裝
Download fingerprint data =
Found similar footprints at system library, it is recommended to use them first. = 發現存在相似的系統封裝，建議優先使用系統封裝。
Copy Title = 復製標題
Check system similar footprint = 檢查系統相似封裝
Can't find the Similar Footprint = 未找到相似封裝
Search failed! = 查詢失敗！
No package information! = 無封裝信息！
Find Parameters = 查找參數
Find Results = 查找結果

Bill of material(BOM) uploaded finish, please click "OK" to continue. = 物料清單(BOM)已經上傳成功，請點擊「確定」繼續。
Bill of material(BOM) upload failed! = 物料清單(BOM)上傳失敗!

All pads = 全部焊盤
All holes = 全部通孔
Single layer pads = 單層焊盤
Multi-layer pads = 多層焊盤
Same X pads = 相同 X 的焊盤
Same Y pads = 相同 Y 的焊盤
Same Y and clearance pads = 相同 Y 和間距的焊盤
Same X and clearance pads = 相同 X 和間距的焊盤
Same X and clearance pads' clearance = 相同 X 和間距的焊盤的間距
Same Y and clearance pads' clearance = 相同 Y 和間距的焊盤的間距
Pad's hole diameter(max) = 焊盤孔直徑(最大)
Pad's hole diameter(min) = 焊盤孔直徑(最小)
Pad's hole diameter(aver) = 焊盤孔直徑(平均)

Try Pro Edition = 嘗試專業版

Generate Solid Region by Objects Outline = 根據輪廓生成實心填充
Generate Polygon Pad by Objects Outline = 根據輪廓生成多邊形焊盤
Select the objects that cannot be generated = 選中圖元無法生成外輪廓

Please compress schematic and PCB as a zip file and then import it, if you only import the schematic you need to binding with the footprint manually. = 請把原理圖和 PCB 壓縮成 zip 壓縮包後導入，只導入原理圖需要手動重新綁定封裝。
Please compress schematic and PCB in ASCII format as a zip file and then import it, if you only import the schematic you need to binding with the footprint manually. = 請把 ASCII 格式的原理圖和 PCB 壓縮成 zip 壓縮包後導入，只導入原理圖需要手動重新綁定封裝。
Import failed! The imported files were not ASCII format, please save the files as "Advanced Schematic ascii(*.SchDoc)" or"PCB ASCII File(*.PcbDoc)" at Altium Designer first, and then import. = 導入失敗！你導入的文件不是 ASCII 格式的，請先在 Altium Designer 另存為「Advanced Schematic ascii(*.SchDoc)」或「PCB ASCII File(*.PcbDoc)」後再導入。
Please save the files as "Advanced Schematic ascii(*.SchDoc)" or"PCB ASCII File(*.PcbDoc)" at Altium Designer first, and then import. = 請先在 Altium Designer 另存為「Advanced Schematic ascii(*.SchDoc)」或「PCB ASCII File(*.PcbDoc)」後再導入
The PCB text will use the editor new font family, the text maybe will appear a little excursion. = 導入的 PCB 文本將使用編輯器新的字體，文本可能會出現輕微變形和偏移。
Because of different file format and element design, the imported element may have some differences, please check carefully. The more information please refer the tutorials. =
EasyEDA is not responsible for any losses caused by format conversion differences, if you do not agree, please do not import. =
Please make sure the EAGLE file is saved in EAGLE v6.0 and higher version. = 請確保選擇的 EAGLE 文件是 EAGLE v6.0 及以上版本保存的文件。
Please compress schematic and PCB as a zip file by KiCad5 and then import it, if you only import the schematic you need to binding with the footprint manually. = 請把原理圖和 PCB 使用 KiCad5 壓縮成 zip 壓縮包後導入，只導入原理圖需要手動重新綁定封裝。
Please make sure the Protel file is exported as ASCII format file. = 請確保 Protel 文件是導出為 ASCII 格式的文件。
Please compress the schematic and corresponding symbols as a zip file and then import it. = 請把原理圖和對應的符號壓縮成 zip 文件再導入。
Tips = 提示

Exists incomplete connection = 存在未完成連接
Found that the board has incomplete connection, please check the nets and ratlines = 發現有板子存在未完成連接，請檢查網絡與飛線

Please save the files as "Advanced Schematic ascii(*.SchDoc)" or"PCB ASCII File(*.PcbDoc)" at Altium Designer first, and then import. =
Tips =
Exists incomplete connection =
Found that the board has incomplete connection, please check the nets and ratlines =

You are not logged in or the login status is invalid, please login and try again. = 尚未登錄或登錄狀態失效，請登錄後再試。

Display Board Cutout = 顯示板子挖槽

Apply New Part =
Apply New Parts for Free =

Migrate to Pro Edition... =
Recommended migrate the Std edition projects to the Pro edition, the Pro edition is more features powerful, and more more smoother. How to migrate: =
1. Download and login the Pro edition. =
2. Via: Top Menu - File - Migrate Standard... =
3. Select the projects or libraries to migrate. =
4. If your projects are saved at local, you can compress the schematic and PCB as a zip file, and then import it to the Pro edition. Via: Top Menu - File - Import - EasyEDA(Standard). =
Open Pro Edition =
Feedback =

Datasheet Extract Wizard =
Or double click here to add image(<5MB) =
Pins Information =
Next Step =
Drop graphic files here =
Please drag graphic file =
Click to cancel loading =
Use rolling wheels to zoom preview screen =
Please add pin information first =
The current environment does not support the paste content from the clipboard =
The current environment does not read the permissions of the clipboard =
Please copy a picture and paste the paste =
Image compression failure =
Please drag or paste image at here =
Pins Data without extraction =
Please make sure the editor is connect with internet, the extraction need some time, please wait a while =
Add image failed, please add an image which small than 5MB =
The image size cannot be more than 2 MB =
Image Type =
SOP type =
QFN type =
Table type =
Clear =
Side =
No permission, please contact project manager to enable permission, after enable please refresh the project list and try again =
During the exam, cross -engineering paste =
The exam has ended and cannot be edited =
Exam remaining time =
Exam is over =
The exam is over and the test papers are being corrected =
Quit out =
The current account does not belong to the current engineering member and cannot create a new documentation =

The generated pads size will little bigger than input size, good for welding =

The project has been published, but after editing, the project becomes unpublished. Do you want to continue? =
You are trying to update components from library, please check the difference before update, if the flipped(mirrored) component(s) on the canvas updated, they will be reset to original status, please notice. Do you want to continue? =
{value}{unit-name}, need more than DRC({drc-value}{unit-name}) =
{value}{unit-name}, need less than DRC({drc-value}{unit-name}) =
Need more than DRC({drc-value}{unit-name}) =
Need less than DRC({drc-value}{unit-name}) =
Incomplete Connection =
Found some objects are far away from board outline, whether if move them at board bottom right corner to good to adjust? =

Auto Pin Placement =
