# Menu
User = Потребител
Join... = Присъединяване...
Login... = Вписване...
Log in = Вписване
Logout = Изход
Change password... = Промяна на парола...
User Preference = Потребителски настройки
System Settings... = Системни настройки...
System Settings = Системни настройки
Crash = Срив
Invite friends... = Покана на приятели...
Language = Език
Language Setting = Езикови настройки

Document Recovery = Възстановяване на документ
Your Preferences Information = Информация за предпочитания
File = Файл
New = Нов
Project... = Проект...
Schematic = Схема
Schematic-Simulation = Схема-симулация
Spice Symbol = Spice символ
Spice Subckt = Spice блок
spicePre = spicePre
PCB = Печатна платка
Schematic Module = Схемен модул
PCB Module = Модул платка
Save... = Запис...
Save As... = Запис като...
Save As Module... = Запис като модул...
Print = Печат
Export Document = Извеждане на документ
LTspice... = LTspice...
Eagle... = Eagle...
Altium... = Altium...
Cadence... = Cadence...
Pads... = Pads...
DXF = DXF
Import = Вмъкване


Edit = Редактиране
Undo = Отмяна
Redo = Преправяне
Cut = Изрязване
Copy = Копиране
Paste = Поставяне
Select = Избор
Delete = Изтриване
Clear All = Изчистване на всичко
Move = Преместване
Drag = Влачене
Bring to Front = Преден план
Send to Back = Заден план
Align = Подравняване
Align Left = Ляво подравняване
Align Right = Дясно подравняване
Align Top = Горно подравняване
Align Bottom = Долно подравняване
Align Horizontal Centers = Подравняване хоризонтален център
Align Vertical Centers = Подравняване вертикален център
Distribute Horizontally = Хоризонтално разпределяне
Distribute Vertically = Вертикално разпределяне
Distribute Left Edges Equidistantly = Равномерно разпределяне по ляв ръб
Distribute Top Edges Equidistantly = Равномерно разпределяне по горен ръб
Align Grid = Подравняване към мрежата
Rotate = Завъртане
Rotate Left = Завъртане на ляво
Rotate Right = Завъртане на дясно
Flip Horizontal = Хоризонтално преобръщане
Flip Vertical = Вертикално преобръщане
Rotate and Flip = Завъртане и преобръщане
Group/Ungroup Symbol... = Групиране/Разгрупиране на Символ

[menu_project]
View = Изглед
[/menu_project]
Find = Търсене
Zoom In = Уголемяване
Zoom Out = Смаляване
Fit in Window = Побери в прозорец
Refresh = Обновяване
Snap = Прилепване
Cross Cursor = Кръстат маркер
Toolbars = Лента с инструменти
Drawing Tools = Чертожни инструменти
Wiring Tools = Инструменти за опроводяване
Power Objects = Мощни обекти //check further
PCB Tools = Инструменти за платка
Footprint Tools = Инструменти за отпечатък
Layers Tool = Инструменти за слоеве
Layer Manager = Управление на слоеве
Enable and Show All Layers = Разреши и покажи всички слоеве
Net Visible = Видима верига //check further
Auto = Автоматично
Digital Objects = Цифрови обекти
Tools = Инструменти
Arc Center = Център на дъга
Arc Type = Тип на дъга
Center Point Arc = Централна точка на дъга
Two-point Arc = Двуточкова дъга

Place = Поставяне
Drawing Tools = Чертожни инструменти
Arc = Дъга
Elliptical Arc = Елептична дъга
Ellipse = Елипса
Circle = Кръг
Pie = Пай
Line = Линия
Polyline = Полилиния
Rectangle = Правоъгълник
Rectangular = Правоъгълен
The rectangle does not support non-90 degree rotation. Please use Solid Region instead. = Правоъгълникът не поддържа завъртане, различно от 90 градуса. Моля използвайте плътен регион, вместо това.

Rect = Прав
Round Rectangle = Заоблен правоъгълник
Polygon = Полигон
Bezier = Безие
Path = Пътека
Graphic = Графика
Bus = Шина за данни
Bus Entry = Вход шина за данни
Junction = Съединение
Net Port = Мрежови възел
Voltage Probe = Напреженова сонда
Power Port = Захранваща връзка
Wire = Проводник
Annotation = Пояснение
Track = Писта
Image = Изображение
Arrow Head = Острие на стрела
Arrowhead = Острие на стрела
Arrow = Стрелка
No Connect Flag = Указател за липса на връзка
Place = Поставяне
Pin = Извод
Lock Selected Objects = Заключване на избраните обекти

Miscellaneous = Разни
Find Component = Търсене на компонент
Component = Компонент
Footprint... = Отпечатък...
This component is deleted! = Този компонент е изтрит!
Convert = Конвертиране
Convert Schematic to PCB = Преобразуване на схема в печатна платка
The component ID will be reset according to the component prefix, this operation will clear Undo histories. Please notice: = Идентификаторът на компонента ще бъде нулиран, съгласно представката му и тази операция ще изчисти историята за отмяна. Моля обърнете внимание:
Please make sure the component prefixes of the schematic and PCB are corresponding = Моля уверете се, че представката на компонента, отговаря на схемата и на печатната платка.
Please reset the component ID of corresponding schematic or corresponding PCB too = Моля нулирайте идентификаторът на компонента и съответната схема или платка.
Do you want to continue? = Желаете ли да продължите?
Reset Component Unique ID = Нулиране на уникалният идентификатор на компонента
Component ID reset successfully! = Идентификаторът на компонента е нулиран успешно!
Convert to PCB = Преобразуване в печатна платка
Update PCB = Актуализация на печатна платка
Shortcut Keys Setting = Настройка на ключове за пряк път
Edit Symbol... = Редактиране на символ...
Highlight Net... = Осветяване на верига...
Simulate = Симулирай
Simulation = Симулация
Standard Mode = Стандартен режим
Simulation Mode = Режим симулация
Change to Standard Mode = Премини към стандартен режим
Change to Simulation Mode = Премини към режим симулация
Welcome to Use LCEDA = Добре дошли в LCEDA
Welcome to Use EasyEDA = Добре дошли в EasyEDA
Enable Education Edition Features for Free >>> = Разрешение за употреба на учебни възможности безплатно >>>
Quick Start = Бързи първи стъпки
More Help = Допълнителна помощ
Explore = Разглеждане
Message = Съобщение
[start]
Example = Пример
Forum = Форум
Tutorials = Упътвания
Videos = Видеа
[/start]
Custom Data = Персонализирани данни
LCEDA = LCEDA

Copy Result Image = Копиране на полученото изображение
Export Result Image = Извличане на полученото изображение
Simulation Result = Резултат от симулацията
Simulation Results... = Резултат от симулация...
Simulate this Sheet = Симулиране на тази страница
Simulate this Project = Симулиране на този проект
Non-simulation mode, please switch to the simulation mode first and then run = Несимулюционен режим, моля първо преминете в режим на симулация и тогява стартирайте
Run the Document = Стартиране на докумнт
Run the Project... = Стартиране на проект...
Netlist for Document = Списък с вериги за докувент
Netlist for Project = Списък с вериги за проект
LTspice for This Sheet... = LTspice за този лист...
Spice for this Project... = Spice за този проект...
Protel/Altium for PCB... = Protel/Altium за печатна платка...
PADS for PCB... = PADS за печатна платка...
FreePCB for PCB... = FreePCB за печатна платка...
Eagle for PCB... = Eagle за печатна платка...
Kicad for PCB... = Kicad за печатна платка...
OrCAD for PCB... = OrCAD за печатна платка...
BOM report... = BOM отчет...
BOM for Document... = BOM за документ...
BOM for Project... = BOM за проект...
Pin Manager... = Управление на изводите...
Spice Model... = Spice модел...
Layer Manager... = Управление на слоевете...
Net Color... = Цвят на веригата...
Design Rule... = Правила за проектиране...
Copper Area = Медна област
Rebuild Selected = Реконструиране на избраното
Rebuild All = Реконструиране на всичко
Copper Area Manager... = Управление на медната област...
Export Pick and Place File = Извличане на файл за Pick and Place
Measure Distance = Измерване на отстояние
Set Canvas Origin by Mouse Location = Обозначаване на координатно начало по местоположение на мишката
Generates Pick and Place File = Генериране на файл за Pick and Place
Unroute All = Премахване на цялото опроводяване
Auto Route = Автоматично опроводяване
Export Autorouter File(DSN) = Извличане на файл за автоматично опроводяване(DSN)
Import Autorouter Session File(SES) = Вмъкване на файл за сесия на автоматично опроводяване(SES)
Autorouter File(DSN) = Файл за автоматично опроводяване(DSN)
Autorouter Session File(SES) = Файл за сесия на автоматично опроводяване(SES)
Terminate Routing Automatically = Автоматично завършване на опроводяване
Delete Segments = Изтриване на сегмент
Unroute Connections = Премахване на връзки
Unroute Connection = Премахване на връзка
Unroute Nets = Премахване на верига
Select = Избор
Segments = Сегмент
Connection = Връзка
Net = Верига
Apply Design Rule While Routing and Auto Placing Via = Прелагане на правило за проектиране при опроводяване и автоматично поставяне на проходник

Add SubPart = Добавяне на подчасти
Annotate... = Добавяне на бележка...
Config = Настройка

Help = Помощ
About = Относно
Shortcut Keys = Ключове за пряк път
FAQ = Често задавани въпроси
Tutorials = Упътвания
Basic Tutorials = Кратки упътвания
Video Tutorials = Видео-упътвания
Essential Check = Проверка по същество
Simulation Tutorials = Упътвания за симулации
Updated Instructions = Обновена инструкция
Open File Format = Отваряне на файлов формат
About Upgrade = Относно надграждане
User Forum = Потребителски форум
Live Q/A = Въпроси и отговори в реално време
No live broadcast now = В момента не е налично излъчване
Feature Request = Бъдеща заявка
Feature Requests = Бъдещи заявки
Bug Report = Докладване на неизправност
Bug Reports = Докладвания за неизправност
Tips & Skill = Съвети и умения
Ask for Help = Попитърсете помощ
Schematic Capture = Улавяне на схема
Spice Simulation = Spice симулация
Non-simulation mode = Режим без симулация
PCB Layout = Разпределение на печатна платка
General Discussion = Обща дискусия
More Information = Допълнителна информация
Privacy Policy = Политика за поверителност
#Terms of Use & Privacy Policy =
Terms of Service = Условия за поддръжка
Plans and Pricing = Планове и цени
Help Translate = Помощ за превод
About Us = За нас
Contact Us = Свързване с нас
Change History = История на промените
Join Us = Присъединете се
#PCB Fabrication Capabilities =
PCB Fabrication = Производство на печатни платки
Order Capabilities = Потенциал за поръчка
Order Price = Цена за поръчка
Order Essential Check = Проверка на поръчка по същество
Order FAQ = Често задавани въпроси при поръчка
Order Process = Процес за поръчка
Full Screen = Цял екран

Support = Поддръжка
[leftNavTabs]
Support = Поддръжка
[/leftNavTabs]
Historical Records... = Исторически записи
Extensions = Разширения
Order PCB... = Поръчка на печатна платка
Import Changes = Вмъкване на промени
Press {0}F11{1} to switch to full screen. = Натиснете {0}F11{1} за превключване на цял екран
Delete Selected = Изтриване на избраното
Simulate... = Симулиране...
Config = Конфигуриране
Terms of Service & Privacy Policy = Условия за поддръжка и политика за сигурност
Help Topics = Теми за помощ
3D Model(obj) = 3D мадел(obj)
3D Model(step) = 3D модел(step)
SVG Source... = SVG източник...
File Source = Файлов източник
Group These Items as a Symbol = Групиране на тези обекти като символ
Group These Items as a Footprint = Групиране на тези обекти като отпечатък
Set Canvas Origin = Задаване на начало на координатната система
Document Setting = Настройки на документ
Sheet Properties = Свойства на лист
Set Board Outline = Задаване на очертания на платката
Teardrop... = Капка...
Panelize... = Ранелизация...
Check Dimension = Проверка на размери
Smart Dimension = Интелигентни размери
Footprint Wizard = Помощник за отпечатък
Footprint Wizard... = Помощник за отпечатък...
Select package type = Избор тип на корпуса
Smart Dimension Properties = Интелигентни свойства на размерите
Global Delete = Глобално изтриване
Cross Probe = Кръстосана проба
Cross Probe and Place = Кръстосана проба и поставяне
Paper Size = Размер на хартията
Register = Регистрация
User Center = Потребителски център

By Mouse Location = Позиция на моята мишка
Set Coordinate = Задаване на координати
By Coordinates... = По координати...
By Center of Pads = По центърът на площадката
By Center Grid of Symbols = По централната мрежив

#Schematic Canvas Properties
Properties = Свойства
Apply = Приложи
Save as default = Запазване като по подразбиране
Canvas Properties = Свойства на чертожното поле
Width = Широчина
Height = Височина
Background = Фон
Visible Grid = Видима мрежа
Grid Visible = Показване на мрежа
Real-Time Track Length =
Display Real-Time Track Length =
Grid Color = Цвят на мрежата
Grid Size = Размер на мрежата
Grid Style = Стил на мрежата
Grid.Line Width = Дебелина на линиите на мрежата
Grid.Line Spacing = Отстояния между линиите на мрежата
Copper to Board Outline =
Improve Fabrication = Подобряване на производство
Spoke Width =
Stroke Color = Цвят на щрих
Stroke Width = Ширина на щрих
Stroke Style = Стил на щрих
Fill Color = Цвят на запълване
Selected Objects = Избрани обекти
Frame Size = Размер на рамката
Alt Snap = Alt прилепване
Snap size when pressing the Alt key = Размер на зоната за прилепване, при натискане на Alt клавиш
Prefix Start = Начална представка

#Text Properties
Text Properties = Текстови свойства
Text = Текст
Color = Цвят
Font Family = Семейство на шрифт
Font Size = Размер на шрифт
Font Weight = Дебелина на шрифт
Font Style = Стил на шрифт
Text Type = Тип на текста
Text Anchor = 
Baseline = Базова линия
(Auto) = (Автоматично)
(auto) = (автоматично)
start = начало
middle = среда
end = край
inherit =
comment = коментар
spice = spice
normal = нормален
italic = курсив
Default = По подразбиране
Add = Добавяне
bold = получерен
bolder = засилен получерен
lighter = олекотен
Failed to parse the font file: {name} = Неуспешен анализ на файл за шрифт: {name}
Please select a font file of ttf or woff format. = Моля изберете файл за шрифт с формат ttf или woff
Add font success: {name} = Успешно добавяне на шрифт: {name}
Failed to add font: {name} = Неуспешно добавяне на шрифт: {name}
Add Font = Добавяне на шрифт
Failed to parse cached font: {name} = Неуспешен анализ на буфериран шрифт
Load cached fonts fail! = Зареждането на буферираните шрифтове е неуспешно!

#Stroke
Stroke Color = Цвят на щрих
Stroke Width = Ширина на щрих
Stroke Style = Стил на щрих
Fill Color = Цвят на пълнеж
X Radius = Радиус по X
Y Radius = Радиус по Y

#spice
Switch mode = Превключване на режим
The current documents will be closed, and reopen after switching mode, do you want to continue? = Текущият документ ще бъде затворен, желаете ли да продължите?
PCB related documents are not allowed in emulation mode = Документите, свързани с печатната платка, не са разрешени в режим на емулация
Please change the editor to "Simulation" mode first at the top left corner. = Моля първо превключете редактора в режим "Симулация", в левия горен ъгъл.
Please change the editor to "Standard" mode first at the top left corner. = Моля първо превключете редактора в "Стандартен" режим, в левия горен ъгъл.
Common = Общ
spice.open = Отваряне на spice
spice.close = Затваряне на spice
Sources = Източници
Instruments/Meters = Инструменти/Измерватели
Transistors = Трянзистори
Digital Circuits = Цифрови схеми
Operational Amplifier = Операционни усилватели
multimeter = мултимери
multimeter Settings = Настройки на мултимери
FunctionGenerator Settings = Настройки на функционален генератар
Voltage Source Settings = Настройки на източник на напрежение
Current Source Settings = Настройки на източник на ток
Powersw Settings = Настройки на Powersw
Resistor Settings = Настройки на резистор
Capacitor Settings = Настройки на кондензатор
Diode Settings = Настройки на диод
voltPowersw Settings = Настройки на voltPowersw
Inductor Settings = Настройки на магнетик
VCVS Settings = Настройки на VCVS
CCCS Settings = Настройки на CCCS
VCCS Settings = Настройки на VCCS
CCVS Settings = Настройки на CCVS
JFET Settings = Настройки на JFET
FET Settings = Настройки на FET
Transmission Line Settings = Настройки за предавателна линия
Oscilloscope Settings = Настройки на осцилоскоп
XFMR Settings = Настройки на XFMR
LOGIC Settings = Настройки на LOGIC
LOGICSTATE Settings = Настройки на LOGICSTATE
DIGITALCLOCK Settings = Настройки на DIGITALCLOCK
Potentiometer Settings = Настройки на потенциометър
MUTUAL_INDUCTORS Settings = Настройки на MUTUAL_INDUCTORS
NE555 Settings = Настройка на NE555
THREE_PHASE Settings = Настройки на THREE_PHASE
Logic_Probe Settings = Настройки на Logic_Probe
78XX Settings = Настройки на 78XX
79XX Settings = Настройки на 79XX
OPAMP5PEE Settings = Настройки на OPAMP5PEE
OPAMP5PEECN Settings = Настройки на OPAMP5PEECN
OPAMP3PEE Settings = Настройки на OPAMP3PEE
OPAMP3PEECN Settings = Настройки на OPAMP3PEECN
DELAY_FUSE Settings = Настройки на DELAY_FUSE
Ratio = Отношение
K[%] = K[%]
Model = Модел
States = Състояния
Voltage[V] = Напрежение[V]
Voltage gain[V/V] = Усилване по напрежение[V/V]
Current gain[A/A] = Усилване по ток[A/A]
Transconductance[Mho] = Преходна проводимост[Mho]
Transresistance[Ω] = Преходно съпротивление[Ω]
Voltage Source Type = Вид източник на напрежение
Current Source Type = Вид източник на ток
multimeter type = Вид мултиметър
power type = Вид мощност 
Voltmeter Resistance(R)(Ω) = Вътрешно съпротивление на волтметър(R)(Ω)
Amperometer Resistance(R)(Ω) = Вътрешно съпротивление на амперметър(R)(Ω)
mu.V = mu.V
mu.A = mu.A
Sine Wave = Синусоиден сигнал
Triangular Wave = Триъгълен сигнал
Rectangular Wave = Правоъгълен сигнал
AC =
DC =
SINE =
PULSE =
EXP =
SFFM =
PWL =
B.spice =
DC Value[V] = DC стойност[V]
DC Value[A] = DC стойност[A]
DC offset[V] = DC отместване[V]
DC offset[A] = DC отместване[A]
Amplitude[V] = Амплитуда[V]
Amplitude[A] = Амплитуда[A]
Freq[Hz] = Честота[Hz]
Theta[1/s] =
Tdelay[s] =
Phi[deg] =
Tperiod[s] =
Ton[s] =
Tfall[s] =
Trise[s] =
Von[V] =
Von[A] =
Vinitial[V] =
Vinitial[A] =
Vpulsed[V] =
Vpulsed[A] =
Rise Delay[s] =
Rise Tau[s] =
Fall Delay[s] =
Fall Tau[s] =
Carrier Freq[Hz] = Носеща честота[Hz]
Modulation Index = Дълбочина на модулация
Signal Freq[Hz] = Честота на сигнала[Hz]
Time[s] = Време[s]
Value[V] = Стойност[V]
Value[A] = Стойност[A]
Waveforms = Осцилограми
Duty cycle[%] = Коефициент на запълване[%]
Amplitude[Vp] = Амплитуда[Vp]
Offset[V] = Отместване[V]
Rise/Fall Time[sec] = Време за Нарастване/Спад[sec]
Capacitance[F] = Капацитет[F]
sComponent = sКомпонент
Inductance[H] = Индуктивност[H]
Gbw =
Slewrate = Скорост на нарастване
Avol =
Rout(Ω) =
Rin(Ω) =
Ibias[A] =
Inhi[V] =
Inlo[V] =
Isc[A] =
Outhi[V] =
Outlo[V] =
Vabsmax[V] =
Vmin[V] =
Iq[A] =
Cin[F] =
high = висок
low = нисък
Oscilloscope = Осцилоскоп
Logic Analyzer = Логически анализатор
Channel_A = Канал_A
Channel_B = Канал_B
Channel A = Канал A
Channel B = Канал B
Time = Време
Reverse = Реверсиране
Simulation file exceed = Надвишен размер на симулационен файл
The simulation file is too large and has been stopped for performance reasons. = Размерът на симулационния файл е твърде голям и е спрян, поради недостатъчна производителност.
Timebase =
Scale: = Мащаб:
X pos.(Div): =
Y pos.(Div): =
View meter... =
The circuit has components without simulation model: = Схемата съдържа компоненти без симулационен модел:
Your simulation interval is too short to simulate, please wait 5 seconds later and try again; if still show this message, may be you simulated over 500 times the maximum simulation times per day. = Симулационният интервал е твърде малък, моля опитайте отново след 5 секунди; В случай, че виждате това съобщение повторно, вероятно сте надвишили максимолните 500 симулации на ден.
Resistor1_US =
Resistor1_EU/IEC =
Resistor1_3D =
Capacitor1_US =
Capacitor1_EU/IEC =
Capacitor1_3D =
Rheostat_US =
Rheostat_EU/IEC =
Rheostat_3D =
Capacitor_Electrolytic_US =
Capacitor_Electrolytic_EU/IEC =
Capacitor_Electrolytic_3D =
Inductor_US =
Inductor_EU/IEC =
Inductor_3D =
Resistor2_US =
Resistor2_EU/IEC =
Resistor2_3D =
Multimeter = Мултиметър
Multimeter_3D =
Oscilloscope = Осцилоскоп
Oscilloscope_3D =
Signal_Generator =
Signal Generator_3D =
Wattmeter = Ватметър
Wattmeter_3D =
NSSWS1080T_3D =
Voltage_Source_VDC =
Voltage_Source_VSin =
Voltage_Source_VPULSE =
Voltage_Source_VEXP =
Voltage_Source_VSFFM =
Voltage_Source_VPWL =
Voltage_Source_V_Behavioral_Source =
Current_Source_IDC =
Current_Source_ISin =
Current_Source_IPULSE =
Current_Source_IEXP =
Current_Source_ISFFM =
Current_Source_IPWL =
Current_Source_I_Behavioral_Source =
CCCS_1 =
CCCS_2 =
CCVS_1 =
CCVS_2 =
VCCS =
VCVS =
Three_Phase_Wye_Load =
Three_Phase_Delta_Load =
78XX =
79XX =
555 =
555_3D =
Transformer_US =
Transformer_EU/IEC =
Transformer_Center_Tapped_US =
Transformer_Center_Tapped_EU/IEC =
Mutual_Inductor_US =
Mutual_Inductor_EU/IEC =
Mutual_Inductor2_US =
Mutual_Inductor2_EU/IEC =
OR2EE_US =
OR3EE_US =
OR4EE_US =
OR2EE_CN =
OR3EE_CN =
OR4EE_CN =
NOR2EE_US =
NOR3EE_US =
NOR4EE_US =
NOR2EE_CN =
NOR3EE_CN =
NOR4EE_CN =
AND2EE_US =
AND3EE_US =
AND4EE_US =
AND2EE_CN =
AND3EE_CN =
AND4EE_CN =
NAND2EE_US =
NAND3EE_US =
NAND4EE_US =
NAND2EE_CN =
NAND3EE_CN =
NAND4EE_CN =
XOR2EE_US =
XOR2EE_CN =
XNOR2EE_US =
XNOR2EE_CN =
Digital_Clock_1Hz =
Logicstate_0 =
Logicstate_1 =
Logic_Probe =
Buffee = Буфер
INVEE_US =
INVEE_CN =
Schmittbuffee =
LM358N_US =
LM358N_CN =
OPAMP3PEE_US =
OPAMP3PEE_CN =
OPAMP5PEE_US =
OPAMP5PEE_CN =
Voltage_Controlled_Switch =
Current_Controlled_Switch =
FUSE = Предпазител
Delay_Fuse =
Transmission_Line =
Crystal = Кристал
DFFEE =
TFFEE =
JKFFEE =
SRFFEE =
SRLATCHEE =
SRNANDFFEE =
SRNORFFEE =
INVTSEE =
INVODEE =
Cbuffer =
SPDT_Open =
SPDT_Close =
SPST_Close =
SPST_Open =
Fast_Crystal =
Lamp = Лампа
BCD_Segment =
Seven_Segment =
Traffic_Light =
Lamp Settings = Настройки на лампа
Power[W] = Мощност[W]
Dropout Voltage[V] = Спад на напрежение[V]
Current[A] = Ток[A]
Threshold[V] = Праг[V]
Clock Rate =
TrafficLight Settings = Настройки на Светофар
BCDSegment Settings =
SevenSegment Settings =
SPDT Settings =
SPST Settings =
LogicAnalyzer Settings = Настройки на логически анализатор
Fuse Settings = Настройки на предпазител
Wattmeter Settings = Настройки на Ватметър
open = отваряне
close = затваряне
Common Anode = Общ анод
Common Cathode = Общ катод
AC Amplitude = AC амплитуда
AC Phase = AC фаза
There are some parts haven't spice model, please use "EElib" and "Spice Symbol" at "Libraries" of "Simulation" mode, or you can assign the spice model for them: = Някои компоненти нямат spice модел. Моля използвайте "EElib" и "Spice Символ" при "Библиотеки" в режим "Симулация" или може да назначите spice модел за тях:

#Pin
Pin Properties = Свойства на извод
Orientation = Ориентация
Line 45° = Линия 45°
Line 90° = Линия 90°
Arc 45° = Дъга 45°
Arc 90° = Дъга 90°
Free Angle = Произволен ъгъл
Start X = Начало X
Start Y = Начало Y
Length = Дължина
Name = Име
name = Име
Number = Номер
Spice Pin Order = Изводна подредба в Spice
Display Number = Екранен номуп
Clock = Тактова честота
Show = Показване
Electric = Електрически

#Junction
Junction Properties = Свойства на съединението
X Location = Позиция по X
Y Location = Позиция по Y
Size = Размер
Color = Цвят

#Net Label
Net Label = Етикет на верига

#Part
Prefix = Представка

#Image Properties and Dialog
Add Image = Добавяне на изображение
Image Properties = Свойства на изображение
Image URL = URL на изображение
Input an image URL = Въвеждане URL на изображение
Invalid image URL = Невалиден URL на изображение
Invalid Prefix = Невалидна представка
Failed to load the image = Неуспешно зареждане на изображение
Image URL contains special characters = URL на изображението съдържа специален символ
From Web URL = От мрежови URL
From Local Computer = От локалния компютър
Please select a png/gif/jpg file. = Моля изберете png/gif/jpg файл.
Please select an image file. = Моля изберете файл, съдържащ изображение.
Select an image file = Избиране на файл с изображение
Insert Image to PCB = Вмъкване на изображение в печатна платка
Tolerance = Допуск
tolerance = допуск
capacitance = капацитет
frequency = честота
Rated Voltage = Номинално напрежение
Rated Current = Номинален ток
resistance = съпротивление
Resistance = Съпротивление
Resistance[Ω] = Съпротивление[Ω]
inductance = индуктивност
Operating Temperature = Работна температура
Shape Invert = Инвертиране на форма
Image Size = Размер на изображението
Color Tolerance = Цветен допуск
Simplify Level = Ниво на опростяване
Corner Threshold = Граничен праг

#PCB Canvas Properties
Units = Мерна единица
Snap Size = Размер на прилепване
Other = Друго
Routing Width = Ширина на опроводяване
[router]
Routing Width = Ширина на опроводяване
[/router]
Please using hotkey {0}{key1}{1} or {2}{key2}{3} to change track width while on routing. =
Routing Angle = Ъгъл при опроводяване
Routing Conflict = Конфликт при опроводяване
Remove Loop = Премахване на цикъл
Cut SilkScreen = Изрязване на скрийншот
Grid = Мрежа
Grid 90 = Мрежа 90
Grid 45 = Мрежа 45
Copper Zone = Медена зона
Visible = Видим
Invisible = Невидим
Ignore = Игнориране
Block = Блокиране
RoundTrack = ЗобиколнаПътечка

#Track
Track Properties = Свойства на писта
Layer = Слой
Net = Верига
Start X = Начало X
Start Y = Начало Y
End X = Край X
End Y = Край Y
ID = Идентификатор

#Pad Properties
Pad Properties =  Свойства на площадка
Shape = Форма
Hole(D) = Отвор(D)
Center X = Център X
Center Y = Център Y
Round = Кръг
Oval = Овал
Hole Shape = Форма на отвора
Slot = Канал
Hole(Length) = Отвор(Дължина)
Plated = Метализация
None = Нито едно
Paste Mask Expansion = Разширяване на маска за паста
Solder Mask Expansion = Разширяване на маска за запояване

#Via Properties
Via Properties = Свойства на проходник
Diameter = Диаметър
Drill Diameter = Диаметър на свредло

#Hole Properties
Hole Properties = Свойства на отвор


#TEXT
Text Properties = Свойства на текст
Line Width = Ширина на линия
Rotation = Завъртане
Fonts Management = Управление на шрифт

#Dimension Properties
Dimension Properties = Свойства на размери

#Footprint Properties
Component Properties = Свойства на компонент
Display Prefix = Изобразяване на представка
Pin Name = Име на извод
Pin Number = Номер на извод
Spice Pin Number = Номер на Spice извод
Graphics = Графика
Pattern = Шаблон

Pin: = Извод:
Netflag: = Мрежови флаг
Netlabel: = Мрежови етикет
NetPort: = Мрежов извод
Voltage Probe: = Напреженова сонда
Pin: = Извод:
Hidden Pin: = Скрит извод:
Unknown: = Неизвестен:
#Arc Properties
Arc Properties = Свойства на дъга
Start Angle = Начален ъгъл
End Angle = Краен ъгъл
Rotation Direction = Посока на завъртане

#Rect Properties
Rect Properties = Свойства на правоъгълник
Round radius = Радиус на заобляне

#Circle Properties
Circle Properties = Свойства на окръжност
Radius = Радиус

#CopperArea Properties
CopperArea Properties = Свойства на медна площ
Clearance = Светло разстояние
Pad Connection = Връзка на площадка
Direct = Директин
Spoke =
Keep Island = Запазване на остров
Fill Style = Стил на запълване
CopperArea conflict: copper area outlines in same layer with different net names must not overlap = Конфликт с медната площадка: очертанията на медни площадки, в един и същ слой с различни имена на веригите, не трябва да се припокриват
Copper area rebuild complete! You can set "Copper Zone" as "Visible" at the right-hand property panel after single click the empty area. = Възстановяването на медните площадки е завършено! Може да заложите "Медната зона" като "Видима", в панела за свойства отдясно, след единично кликване в празната зона.
Please create board outline first. = Моля първо създайте очертанията на платката.
Board outlines are not closed. = Очертанията на платката не са затворени.
Rebuild CopperArea = Възстановяване на медна площадка
Edit Points = Точки за редакция
Direct = Насочване
Spoke =
No Solid = Безплътно
Board Cutout =
Solid = Плътно
[copperArea]
None = Нито едно
[/copperArea]

#Custom Properties
Custom Properties = Персонализирани свойства
Fixed Properties = Фиксирани свойства
Add new parameter = Добавяне на нов параметър
Add New Parameter = Добавяне на нов параметър
Add New Supplier = Добавяне на нов доставчик
Mounted = Монтиран
Unknown = Неизвестен

Custom = Персонално
Scan the QR code below and open it on the mobile side = Сканирайте QR кодът по-долу и го отворете в мобилния сайт
How to create a single layer PCB = Как да създадете еднослойна печатна платка
Currently doesn't support layout single layer directly, please refer at: = Понастоящем не се поддържа разпределение със единичен слой по директен начин, моля обърнете се към:

#Dialog Register
Create an account = Създаване на акаунт
Username = Потребителско име
Password = Парола
Confirm Password = Потвърждаване на парола
Email = Електронна поща
Please read this before you register = Моля прочетете това, преди да се регистрирате
Hi {username} = Здравейте {username}

#Dialog lostPassword
Lost Password... = Загубена парола...
Find the password using your email = Открийте паролата, чрез вашата електронна поща



#Dialog Login
Login = Вписване
Username or Email = Потребителско име или електронна поща
Remember Me = Запомни ме
Third party = Трета страна
Login and Register = Вписване или регистрация
Your login information seems expired, please login again. Don't need to close the opening files, you can continue to save them after login. = Вашата информация за вписване изглежда е изтекла, моля впишете се отново. Не е нужно да затваряте отворените файлове, ще продължите да ги записвате, след вписването.

#Dialog Reset Password
Reset a password using your email = Възстановяване на парола, чрез вашата електронна поща
Your registered email = Вашата регистрирана електронна поща

#Dialog Reaction
Re-send an activation code to your email = Код за активация е изпратен повторно на вашата електронна поща

#Dialog Invite
Invite friends to register = Поканете ваш приятел за регистрация
Your friend's email = Електронна поща на вашия приятел

#Dialog Add A New Parameter
Add a new parameter = Добавяне на нов параметър
Key = Ключ
Value.new_para =
In BOM = в BOM
Add into BOM = Добавяне към BOM
Invalid key = Невалиден ключ
This field is required. = Това поле е необходимо.

#Dialog Change Your Password
Change your password = Промяна на вашата парола
Old password = Стара парола
New Password = Нова парола
Confirm Password = Потвърждаване на парола

#Dialog Create New Design
Save as a New Project = Запис като Нов проект
Save as a schematic = Запис като Схема
Save as Symbol = Запис като Символ
Save as a spice Symbol = Запис като spice символ
Save as a spice subckt = Запис като spice subckt
YOU MUST CREATE A SPICE SYMBOL WITH EXACTLY THE SAME NAME AS THIS SUBCKT = Трябва да създадете Spice символ с точно същото име като на този SUBCKT
Save as a PCB file = Запис като файл за печатна платка
Save as Footprint = Запис като отпечатък
Save as a Schematic Module = Запис като схемен модул
Save as a PCB Module = Запис като модул за печатна платка
Save as 3D Model = Запис като 3D модел
Save as a WaveForm = Запис като осцилограма
Title = Заглавие
Share = Споделяне
Add file = Добавяне на файл
Visibility = Видимост
Allow Comments = Разрешете коментари
Public (Anyone can see this project but only you can modify it.) =
Private (Only you can see and modify this project) =
Create new project success! = Създаването на нов проект е успешно!
You can now create files under this project = Вече може да създадете файлове в този проект
This file must be saved under a project, choose other project or create a new project =
Please login to save this kind of document =
Duplicated project title = Дублирано заглавие на проект
#Duplicated document title =
Project does not exist = Проектът не съществува
Document does not exist = Документът не съществува
document not exists = документът не съществува

Categories = Категории
Project = Проекти
Short description = Кратко описание
Content = Съдържание
Modify this project info. = Промяна на информацията към този проект.
Modify this file info. = Промяна на информацията към този файл.
Notice =
Search for it before creating a new one. = Потърсете го преди да създадете ново.
Manufacturer Part Number = Производствен идентифакицонен номер
Supplier = Доставчик
Or = Или
Supplier Part =
Supplier Part Number =
Link =
link =
The professional function please refer at: =

#Dialog Clone My Part
#Clone it to a project =
#Clone it, then edit it =
Clone your file =

#Dialog Subckt
Attach a Subckt to this spice symbol =
Subckt string =
Spice symbol title just allow [0-9][a-z][A-Z] and _ =

#Design Manager
Design Manager =
Nets =
DRC Errors =
Are you sure you want to unroute this net? =
Unroute =
Track Length =
Via/Hole Outer Size =
Filter nets =
Design Rule Checking =
Board Outline =
Plane Zone =
[drcRule]
Width =
DRC Width =
Length =
DRC Length =
Drill Diameter =
DRC Drill Diameter =
Diameter =
DRC Diameter =
Object =
DRC Clearance =
[/drcRule]
#It will take a while to unroute this net, do you want to continue? =
More than one netlabel is found in wire, please checked whether this is correct, if you design it on purpose, please ignore this warning. =
Incomplete net, a complete net should contain two or more pins, if you design it on purpose, please ignore this warning. =
This netlabel is not connected with any pin. =
Incomplete connection, please check. =
The clearance between two objects is less than the Design Rule Checking (DRC) clearance which has different nets. =
The diameter is less than Design Rule Checking (DRC) diameter =
The drill diameter is less than Design Rule Checking (DRC) drill diameter =
The track length is longer than Design Rule Checking (DRC) track length =
The track width is less than Design Rule Checking (DRC) track width =

#Dialog Simulation
Show your simulation report = Показване на доклад за сималиция
Download netlist = Изтегляне на списък с вериги
Run = Стартиране
Components = Компоненти

#Dialog Import
Import file from your computer = Вмъкване на файл от вашия компютър
Maximum file size: 30 MB = Максимален размер на файла: 30 MB
Maximum file size: 100 MB = Максимален размер на файла: 100 MB
Chose file = Затваряне на файл
File Operation = Файлова операция
Import File = Вмъкване на файл
Extract Libs = Извличане на библиотека
No Libs! = Липсва библиотека
Import File and Extract Libs = Вмъкване на файл и Извличане на библиотека
File type = Тип файл
The file size is too large. = Размерът на файла е твърде голям.
Please selected the file type. = Моля изберете типа файл
No component was found! = Нито един компонент не е открит!
Import successfully = Вмъкването е успешно
Import failed = Вмъкването е неуспешно
Click OK to continue with the import = Кликнете ОК за да продължите с вмъкването
Select None = Нито едно не е избрано

#Dialog Modify Symbol Information
Modify symbol information =
Spice Prefix = Spice представка
Hide Pin =
Pin Manager =
When a power pin is hidden, it will be marked as netlabel, you don't need to wire it. If you use it as simulation, please show it or create a GND/VCC Net for it. =
Assign =
Supplier.bom =
LCSC.bom =
Price =
Quantity.bom =
Package.bom =
Components.bom =
Manufacturer Part.bom =
Manufacturer.bom =

One-click Purchasing at LCSC =
Order Parts =
Export BOM =
Upload to LCSC ERP = 
No components, upload failed! = 
Upload to LCSC ERP failed, please try again later. = 
Current BOM upload to Chip Manager of LCSC successfully, click "OK" button to access Chip Manager. = 
Upload to LCSC ERP failed, found some components miss some properties value, please check property "Footprint, Manufacturer Part" value if exist. = 

Export PCB BOM =
Export Schematic BOM =
ID.bom =
Name.bom =
[bom]
Name =
LCSC Assembly =
Value =
ID = Идентификатор
Supplier =
LCSC =
Price =
Quantity =
Package =
Components =
Manufacturer =
[/bom]
Manufacturer Part =

#Dialog Run
Run your simulation = Стартиране на вашата симулация
Transient =
Maximum Timestep = Максимална времева стъпка
Stop Time = Крайно време
Start Time = Начално време

AC Analysis =
Type of Sweep =
Number of points =
Start Frequency =
Stop Frequency =

DC sweep =
Source to Sweep =
Start Value =
Stop Value =
Increment =
DC Transfer =
Output =
Source =

DC op pnt =
Compute the DC operating point treating capacitances as opens and inductances as shorts =

#Dialog Share Info
Active File =
Active Project =
Readonly =
Editable =
Active file's owner project page =
Active project editor page =

#Dialog Document Recovery
All Projects =
Document Recovery =
Unsaved files =
Please select a file! =
Please expand the folder first, then select a document to recover. =
Are you sure you want to remove this backup? =

#Dialog Find Libs
Search =
Search Results =
Search and press Enter =
Keywords at least 3 characters =
Assembled =
Verified =
In stock =
{page} of {pagecount} pages =
Common Modules =
User Contributions =
More =
Modify Model... =
Add Favorite =
Remove Favorite =
Add Sub Part =
Untagged =
Package =
package =
Title(PartNO) =
No Data! =
Quantity =
Manufacturer Part =
manufacturer Part =
Manufacturer =
manufacturer =
voltage =
Library =
LCSC Assembled =
JLCPCB Assembled =
User Contributed =
Symbol =
Follow =
Types =
Classes =
power =
Power =
LCSC Part# =
Stock =
Report Error... =
Report Error =
Thanks for your feedback! =
Report error success, thanks for your report! =
The content must be at least 2 characters! =
This library is user contributed, please check before using. =
[lib]
All =
System =
Personal =
Created =
Favorite =
No Team found. Please join or create a team first. =
Create a team =
No follow user found. Please follow your friend first. =
[/lib]


BUY =
In Stock =
Out of Stock =
Minimum =
Distributor =

Capacitance =
Frequency Tolerance =
Power (Watts) =
Power - Max =
Frequency =
Voltage Rating(Vdc,Vac) =
Voltage =
Current Rating =
Rated current =
Resistance (Ohms) =
Resistance(Ohms) =
Inductance = Индуктивност
FET Type =
Current Rating(Max) =
Impedance @ Frequency =
Voltage - Input (Max) =
Voltage - Input (Min) =
Voltage - Supply =
Voltage - Max =
Current - Output =

#Dialog Export Your Works
Export your works =
Export to =
Zoom =
Image Type =
Qualify =
0 means real size =
Merged layer =
Separated layer =
Paged layer =
Layer =
Export =
Mirror =
TopLayer =
BottomLayer =
TopSilkLayer =
Protractor Properties =
BottomSilkLayer =

BoardOutLine =
TopAssembly =
BottomAssembly =
Mechanical =
DocumentLayer =
Inner{number} =
Substrate{number} =
Color =
Full Color =
Canvas Setting =
Full Graphics =
Assembly Drawings =
Object Outlines =
Invalid file format =
Failed to export file =
Download now =
Wire Width =
Sheet =
Merged sheet =
Separated sheet =
Engine =
Exporting PDF =
Export 3D Model =
[exportDocument]
Size =
[/exportDocument]

#Dialog Import Changes
Confirm Importing changes information =
You can't undo this operation, Please run a Design Rule Checking (DRC) after this operation. =
Apply Changes =
This is a simple Design Rule Checking (DRC). =
It just can help you to find the obvious errors =
There are some unfinished nets, do you want to check the nets first? =
Yes, Check Nets =
No, Keep Going =

#Dialog Layer Manager
Configured =
Layer Name =
TopPasterLayer =
BottomPasterLayer =
TopSolderLayer =
BottomSolderLayer =
TopPasteMaskLayer =
BottomPasteMaskLayer =
TopSolderMaskLayer =
BottomSolderMaskLayer =
ComponentShapeLayer =
LeadShapeLayer =
ComponentMarkingLayer =
Ratlines =
Ratlines Color =
Manage Colors =
BoardOutline =
Multi-Layer =
Hole =
DRCError =
Setting =
Drawing area =
Export area =
Transparency(%) =
Copper Layer =
Signal =
Plane =
Non-Signal =
Other =
Please delete all the objects of the layers first! The layers are: =
You are converting Signal Layer to Plane Layer, There're some non-track objects remain on following layers. Please delete the objects manually on the canvas. =
Please delete all the objects of this layer first! =

#Dialog Fabrication Output
Create Files =
Check your {0}Gerber files{1} carefully before sending them to the factory =
Download free Gerber Viewer (gerbv) =
Before generating the Gerber files =
Please check the packages size and orientation carefully. =
Please check for Design Rule Checking (DRC) errors in the Design Manager. =
Please rebuild the copper area after modifying tracks and packages. =
After generating the Gerber file, please use the {0}Gerber Viewer{1} to check whether it conforms to the design requirements. =
Order PCB/SMT =
Found the complicated polygon that object cannot be generated at Gerber, please remove or replace =
ID: {id}, Object: {object}, Location: {location} =

#Dialog DRC
Item =
Value =
value =
Unit =
Track Width =
Track to Track =
Track to Pad =
Pad to Pad =
Via to Via =
Via Hole Size =
Realtime DRC =
{0} is too small! =
Invalid DRC Rule =
Rule =
Via Diameter =
Via Drill Diameter =
Net List =
Rule =
Set Rule =
Check Object to Copper Area =
Show DRC Boundary while Routing =
Check Object to Board Outline =
Rule name already exists! =
You should not delete default rule! =
Rule list contains invalid rule setting! =
Duplicate rule name exists! =
via diameter is smaller than via drill diameter! =
Currently rule name is not allowed to contain magical characters like . and $ =
[drcRule]
All =
[/drcRule]

#Dialog Hotkey
Change Canvas Unit =
Copy Selected Object(s) by Reference Point =
Fullscreen =
Undo the Previous Draw =
Set Canvas Origin by Coordinate =
Switch to the Next Signal Layer =
Switch to the Previous Signal Layer =
Switch object to top layer or bottom layer =
Cycle Forward to the Next Open Tabbed Document =
Cycle Backward to the Previous Open Tabbed Document =
Switch to the Previous Layer(on the Numeric Keypad) =
Switch to the Next Layer(on the Numeric Keypad) =
Toggle Layers Which is Not Active =
Hotkey Setting =
Document Type =
Shortcut =
Function =
ALL =
SCH =
Rotate Selected Objects =
Scroll or Move Selected Left =
Scroll or Move Selected Right =
Scroll or Move Selected Up =
Scroll or Move Selected Down =
Set canvas origin to the center grid of graphics in symbol; Set canvas origin to the center of pads in footprint. =
Cross Document Paste =
Explore & Find Components =
Select All =
Cancel Current Drawing =
Save =
Drag Tool =
Draw Wire =
Draw Bus =
Bus Entry =
Junction =
Net Flag GND =
Net Flag =
Draw Polyline =
Draw Polygon =
Draw Bezier =
Draw Arc =
Draw Rect =
Draw Ellipse =
Freehand Draw =
Freedraw =
Draw Text =
Edit Selected Symbol =
Draw Track =
Draw Circle =
Cycle Select Object at Current Location =
Draw Dimension =
Draw Connect =
Draw CopperArea =
Change to TopLayer;<br/>Change Selected Component's Layer to TopLayer; =
Change to BottomLayer;<br/>Change Selected Component's Layer to BottomLayer; =
Change to Inner1 =
Change to Inner2 =
Change to Inner3 =
Change to Inner4 =
Highlight Net =
Highlight Network =  
Unhighlight Network =  
Place Pad =
Place Via =
Measure =
Change Routing Angle =
Change Routing Conflict =
Decrease Routing Width =
Increase Routing Width =
Decrease Snap Size =
Increase Snap Size =
Change Copper Zone Visible or Invisible =
Rebuild All Copper Area =
Toggle PCB Net Display =
Show Property Dialog When Placing Object;<br/>Show Location Setting Dialog When Pasting Object(s) =
Show Property Dialog When Placing Object;<br/>Show Absolute Offset Dialog When Selecting Object(s);<br/>Show Location Setting Dialog When Pasting Object(s) =
Show Relative Offset Dialog When Selecting Object(s) =
Open the FAQ Page =
Move Object(s) by Reference Point =
Choose Favorite Track Width While Routing =
Copy Selected Object(s) and Paste Repeatedly =

#My Projects Tree Menu
New Project =
New Schematic =
New PCB =
New Spice Subckt =
Modify =
Delete =
Add sub part =
Clone =
Version History =
Refresh List =
Create New Project =
Delete =
Attachment =
Archive =
Transfer =
Manage Project =

#Dialog Verify Package
Footprints Verification =

#Dialog Edit Polygon Pad points
Edit Points =
Center point is outside the pad =
Hole should be inside the pad =
Hole is draggable =

#My Part Tree Menu
Clone =
Reload parts =
Layers =

#Dialog Preferences
Language =
Display Name =
HotKey Sync =
My Theme Sync =
Document Recovery Setting =
Enable auto backup =
Maximum backup level =
Auto backup interval =
minutes =
Save to Server =
Load from Server =


#Dialog Schematic Library Wizard
Symbol Wizard =
Style =
Picture =
Pin Names =
Contributor =
contributor =
owner =

#Dialog Annotate
Annotate =
Scope= 
All pages =  
Current page only =  
Selected components =  
All Opened Schematics =
Method =
Re-annotate all =
Keep existing annotation =
Direction =
Rows =
Cols =
Reset =

#Dialog Order
Order... =
PCB Qty. =
PCB Thickness =
PCB Dimension =
Automatic calculation =
PCB Color =
Green =
White =
Blue =
Red =
Yellow =
Black =
Purple =
Copper =
Gold =
Silver =
Surface Finish =
Hasl =
Hasl(Lead Free) =
ENIG =

#Dialog Hot Key config
Restore All Default Shortcuts =
Save Changes =



#Dialog Polyline Maybe Wire
To connect electrical elements, please use Wire (W hotkey) and not Line (L hotkey). =

Anonymous File =
Anonymous File can not be cloned, but you can open it, then save it as a new file. =
Free Documents =
You must close the file before delete it! =
Offline Project =

#Message box
Confirmation =
Alert =
Information =
information =
Prompt =
Error =
error =
error! =
Warning =
Imported ok! =
Some changes have not been saved. =
Your file hasn't been saved. Please save first! =
Your file hasn't been saved. Are you sure you want to close it? =
Error! Please try again later. =
Are you sure you want to reload this page? =
Are you sure you want to leave this page? =
Confirm Reload =
Confirm Close =
Reload this page =
Leave this page =
Stay on this page =
Don't reload =
No connect flag only can be placed on Pin dot or the wire which is connected one Pin. =
can not be placed on the wire which is placing No Connect Flag. =
The footprint transfer to LCSC library class successfully =
Device/Footprint goes into "SMT Device/Footprint Verified" list successfully =

Load failure! =
Load projects failed =
error info =
error information =
Guest can't create a new project. Please login! =
Please create a project before you do this! =
Add Part success =
Click the new part and then edit it! =
Delete my work =
Delete my work. (Only deletes it from this list but not from the server) =
Do you confirm this? =
Successfully deleted! =
Successfully Copied! =
Cloning success! =
Your title is too short! =
Remove this part =
Find and Jump to ... =
Please type the prefix, such as U1, R1, C1 = Моля въведете представката, например U1, R1, C1
Zoom as 1:1, you can print it and then create artwork for etching the PCB. =
Exporting your works! =
Guests can't import a file. Please login! =
Please create a project before you import a file! =
Import your LTspice file! =
Open LTspice file =
Open EasyEDA file =
Please make sure the selected LTspice file is a file saved in LTspice V and above. =
Saved successfully! =
Save failed! =
Can not place parts into this document. =
User Package =
System Package =
File error =
Please save your file first! =
Email address is too short! =
You have not selected a file to upload. =
Update =
No changes, the PCB already matches the schematic! =
Only public files can be shared =
Conversion to PCB has failed! =
Your username is too short! =
Your password is too short, it must be more than 6 characters! =
Conflicting shortcut =
There is an empty PCB file. Please first run Convert Schematic to PCB... from the schematic =
This file has been modified, are you sure you want to run this simulation before saving it first? =
Please enter the Maximum Timestep! =
Please enter the Stop Time! =
All of these fields are needed. =
Either your spice netlist is too big or the server is busy. Please try again later. =
Your spice netlist is too big! Try breaking your circuit into smaller simulatable blocks. =
Too many users in simulation. Please try again later! =
Due to limited server resources, please wait 10 seconds for the interval in every time simulation. =
Your circuit is too complex, we have not enough CPU resource to support this simulation, please reduce your circuit as small as you can. =
Simulation is queuing, try again after 30s. =
Timeout =
Demo accounts don't support simulation, please login first =
Please login first =
The schematic is showing errors, please check the simulation report carefully! =
Simulation too long, maybe your schematic is too complex. =
Non-simulated file =
This file can only be opened in standard mode. To open it, please switch to standard mode. =
Load your preferences success! =
Save your preferences success! =
Update subckt ok! =
Clone your file =
Please type a new file name =
Create file failure! =
Schematics and PCBs can't be imported under My Libs folder, please choose a different folder =
Libraries to be imported under My Libs folder =
Please choose only the libraries needed =
Maximum import is 200 libs at one time! =
You libraries will be found under the My Libs folder =
Add to Library =
No items have been checked! =
Nothing was found, please create it for yourself =
Search result =
At least 3 characters needed =
Add to my Favorite Parts =
Added it OK. Please find it in your Favorite Parts =
Please select its parent node =
Libraries can not be exported as active project pdf. =
Error:No GND =
This circuit does not have GND. Please select GND from the circuit tool to add to the circuit. =
Current circuit doesn't has Voltage Resource or Current Resource symbol, please place it first at left side EElib or Spice Library. =
Probe can not connect with ground(GND)! =
Spice symbols's properties can't be empty. =
Error:No Spice Symbol =
Simulation limit =
There is a multimeter in the circuit that needs to be simulated using the emulation command .tran or .op =
An oscilloscope exists in the circuit and needs to be simulated using the simulation command .tran =
There are components in this circuit that do not have a simulation model. Please use the base library component of the simulation mode for simulation. =
Circuit does not have a probe =
Make sure your pin numbers are even numbers =
Duplicate Components Prefix = Дублиране на представка на компоненти
All components are hidden successfully! =
All ratlines are hidden successfully! =
Hidden the ratline of net {netName} successfully! =
Duplicate Component Prefix = Дублиране на представка на компонент
{0} exist =
Modify successfully, but {0} already exists =
There are some invalid packages, are you sure? =
Invalid Characters, library only allows [0-9a-zA-Z-_] =
Annotation success =
If you accept this annotation operation, please save your files. If not, close your files without saving. =
This file can't be saved under libs project. Please choose other project or create a new project =
Your file is unsaved. =
You can close the editor now. Have a good day! =
Successfully logged out =
You have at least one unsaved file open. Please save it or close it. =
Please select a reference point =
Please save your file before this operation =
Please open a PCB document =
Please save your file before '{0}'. =
Please try again after saving this file. =
This text can not be empty! =
Export to Altium fail, please try again or contact us. =
Connecting to server =
Please login before asking for help =
This file has been modified, please save it first! =
Remove this param =
You cannot drag a part to the canvas, please click the part and move the cursor to the canvas and then right-click to place. =
Undo/Redo temporary error =
We are sorry but there is an unpredictable error in the undo/redo process. This problem will be fixed soon but in the meanwhile it is safe to continue working on your design. =
The schematic has duplicate prefixes of the components, please make them unique. You can check them using the Design Manager. =
Found duplicated prefix components, can not Import Changes, please modify the duplicated prefix or delete related component. =
Please click the below help button to find out how to fix this problem. =
Please create a board outline! Click the help button to find out how to create a board outline. =
Can not fetch files from server, please check your network and try again =
Please open a schematic first! =
Can not find the schematic of this PCB =
invalid points! =
This file does not support this operation. =
Net Name Conflict =
Net name =
{0} are in the same wire, please remove others and just keep one. =
This field can't be removed! =
Annular ring of the pad/via is too small =
The size of the hole cannot exceed the size of the pad =
Are you sure you want to create a multi-sheet designs? =
Are you sure you want to create a {0}multi-sheet designs{1}? =
Please build the copper area! Click the help button to find out how to build the copper area. =
Suggest to set a package for this component first! =
Please select an opened document first. =
Some files failed to load. Please reload the page. =

#UI Intro
Skip =
« Back =
Next » =
Done =
This is the user management menu. =
This is the toolbar. =
This is the navigation list. Under here you can find projects, files, parts and libraries. =
Show or hide the toolbar to the top of the window here. =
Show, resize or hide the left sidebar to the left of the window here. =
Show or hide the right sidebar to the right of the window here. =

#Standard libs
Passive Components =
Power Supply =
Diodes =
Regulator =
Transistor =
Transformers =
Gates =
Vacuum Tubes =
Switch =
Relay =
Capacitor(US) =
Capacitor(EU) =
Capacitor(EU)2 =
Electrolytic Capacitor(US) =
Electrolytic Capacitor(EU) =
Electrolytic Capacitor(US)2 =
Electrolytic Capacitor(EU)2 =
Inductor(US) =
Inductor(EU) =
Potentiometer_US =
Potentiometer_EU/IEC =
Potentiometer_3D =
Resistor(US) =
Resistor(EU) =
Resistor 45 Deg(US) =
Resistor 45 Deg(EU) =
Variable Capacitor(US) =
Variable Capacitor(EU) =
Variable Resistor(US) =
Variable Resistor(EU) =
Variable Inductor(US) =
Variable Inductor(EU) =
Varistor =
Inductor2(US) =
Inductor2(EU) =
Battery =
Voltage Source =
Current Source =
CCCS(Current Controlled Current Source) =
CCCS2(Current Controlled Current Source) =
VCCS(Voltage Controlled Current Source) =
VCVS(Voltage Controlled Voltage Source) =
CCVS(Current Controlled Voltage Source) =
CCVS2(Current Controlled Voltage Source) =

BV(Behavioral Voltage Sources) =
BI(Behavioral Voltage Sources) =
Epoly(Non-linear Voltage Source) =
Gpoly(Non-linear Current Source) =

Diode =
LED =
LED_3D =
Schottky Diode =
Varactor Diode =
Zener =
Unidirectional TVS Diode =
Bidirectional TVS Diode =
Diac =
Bridge =
78XX =
79XX =
LM317 =
LM337 =
TL431 =
BJT(NPN) =
BJT(PNP) =
MOSFET(Nch) =
MOSFET(Nch) Depletion Four-pins =
MOSFET(Nch) Enhancement =
MOSFET(Nch) Enhancement Four-pins =
MOSFET(Pch) =
MOSFET(Pch) Depletion Four-pins =
MOSFET(Pch) Enhancement =
MOSFET(Pch) Enhancement Four-pins =
JFET(Nch) =
JFET(Pch) =
Darlington NPN =
Darlington PNP =
MESFET(Nch) =
MESFET(Pch) =

IGBT =
SCR =
Triac =
Transform(US) =
Transform(EU) =
Transfrom(NEUTRAL-CTR TAP)(US) =
Transfrom(NEUTRAL-CTR TAP)(EU) =
Mutual Inductors =
Mutual Inductors2 =
Or Gate =
Xor Gate =
And Gate =
Nor Gate =
Nand Gate =
Not Gate =
Xnor Gate =
Tube Diode =
Tube Triode =
Tube Tetrode =
Tube Pentode =
Voltage Controlled Switch =
Current Controlled Switch =
SPST ON =
SPST OFF =
Fuse =
555 =
555(Style2) =
Speaker =
XTAL =
5pin Operational Amplifier =
3pin Operational amplifier =
Transmission Line =
Voltmeter =
Ammeter =
LAMP =
Opto Transistor =

#Server Message
Need login =
Bad password =
We can't find your username or your email, please check it! =
Make sure your uploaded file size is less than 3MB! =
Bad file type =
Empty file or bad file type, ensure your file is Eagle 6.0+ =
This operation not supported on demo account =
Can not share this file under a private project, please set the active project to public! =
Login Failed Too many attempts. If you forgot your password, please {0}reset your password{1} or send an email to support@easyeda.com =

#Dialog Common Buttons
Common Buttons Setting =
Menu Setting... =
Show/Hide =
Move Up =
Move Down =
Reset All =
Zoom =
Place Pin =

#System Setting Dialog
System =
Zoom Mode =
Scroll Key =
CTRL + Scroll =
Canvas Coordinate System =
SVG Coordinate =
Cartesian Coordinate =
Open Wizard Dialog for New Schematic =
Default Unit =
Canvas Zoom Effect =
Quality Priority =
Speed Priority =
Rotation Step =
Add Teardrop Automatically =
Assign Net for Free Track/Arc/Circle =
Open Wizard Dialog for New PCB =
Rebuild Plane Automatically =
The Track's Routing Follows Component's Rotation =
Display Pad's Number and Net =
Favorite Track width =
Track Width Setting =

#Dialog Access Control
Permissions =
Operations =
Access Control =
Project Access Control =
Reject =
Add User =
Bad email address =

#error info from backend
Can't find this email address in EasyEDA. Your partner must be an EasyEDA user. =

#Dialog waveForm
Grid Background =
Pane Background =
WaveForm Config = Настройка на осцилограма
Export Waveform = Извличане на осцилограма


#attr-canvas-grid-style
dot = точка
line = линия

#attr-canvas-frame-size
Other = Други
A4 Portrait =
A4 Landscape =
A3 Portrait =
A3 Landscape =
A2 Portrait =
A2 Landscape =
A1 Portrait =
A1 Landscape =
Landscape =
Portrait =

#Stroke Style
solid = Плътен
dashed = пунктиран с терета
dotted = пунктиран с точки

#Solid Region
Solid Region = Плътен регион
Type = Тип
type = тип

#Dialog Libs Management
Report error = Докладване за грешка
Please give us some information to help us find the problem. = Моля дайте допълнителна информация за да ни помогнете да отквием проблемът.
Cannot place parts into this document: Schematic Symbols can only be placed into a Schematic; PCB Footprints can only be placed into a PCB. = Компонентът не може да се постави в този документ: Схематичният символ може да бъде поставен само в схема; Отпечатъкът може да бъде поставен само в печатна платка.
Save it as a favorite part = Запис като любим компонент
Only logged-in users can save this component as a Favorite Part but guest (Anonymous) users can place this component into their design directly. Would you like to place this component now? = Само потребителите, които са влязли с личен акаунт, могат да запишат този компонент като любим, но гостите (Анонимни) могат да поставят компонента в своята директория на проекта. Вихте ли желали да го поставите сега?

#Others
Find libs = Откриване на библиотеки
My Projects = Моите проекти
My Parts = Моите компоненти
My Modules = Моите модули
Assembly LCSC Components = Сглобени LCSC компоненти
Modules = Модули
SCH Module = SCH модул
PCB Module = Модул за печатна платка
System IC = Системна идентификация
LCSC (Official) = LCSC (Официално)
LCSC Electronics =
Simple Mode = Опростен режим
Expand Mode = Разширен режим
Help Verify = Помощ за проверка
Favorite Parts = Любими компоненти
Shared With Me = Споделени с мен
Preview = Преглед
Preview Window = Прозорец за преглед
System Default = По подразбиране за системата
User Defined = Посочени от потребителя
Theme = Тема
Theme Setting = Настройка на тема
Close = Затваряне
Open = Отваряне
Toggle toolbar = Превключване на лента с инструменти
Toggle left bar = Превключване на лява лента
Toggle right bar = Превклячване на дясна лента
Reload = Презареждане
Mouse-X =
Mouse-Y =
Mouse-DX =
Mouse-DY =
Bus entry x1 =
Bus entry x2 =
Bus entry y1 =
Bus entry y2 =
Yes = Да
No = Не
OK = ОК
Confirm = Потвърждавам
Continue = Продължи
Cancel = Отказ
Update = Актуализация
Bus entry =
Filter = Филтър
Check = Проверка
Share my work = Споделяне на труд
Share it by e-mail, IM, blog, etc. = Споделяне по ел.поща, IM, blog и други.

Copy the contents of this box into a text editor, then save the file. Paste the edited text back into this box and click Apply to update the display. =
Copy the contents of this box into a text editor, then save the file with a .svg extension. You can edit it in Inkscape or open it in your browser. =
Content is too big to show, you can download it directly. =
SVG format =
SVG File =
Description should be no more than 250 letters = Описанието трябва да бъде с не повече от 250 символа.
The file save operation has timed out. Try again and check your Internet connection. = Операцията по записване се забави. Моля проверете вашата връзка с интернет.
Export Netlist = Извличане на списък с вериги
Notifications = Известия
Please select txt or json files. = Моля изберете txt или json файлове.
Please select EasyEDA files. = Моля изберете EasyEDA файлове.
Failed to read file [{file}] = Неуспешен прочит на файл [{file}]
[{file}] is not a valid json file = [{file}] не е валиден json файл
Invalid parameters! = Невалиден параметър!
Download = Сваляне
Start = Старт
You have unsaved files, are you sure you want to log out without saving the files? = Имате незаписани файлове. Сигурни ли сте, че желаете да напуснете, без да направите запис?
Please use the web version to run this function. = Моля използвайте web версията за да стартирате тази функция.
Please save this file to you project! = Моля запишете този файл към вашия проект!
Nothing changed = Нищо не е променено
Delete Node = Изтриване на възел
This layer is invisible. = Този слой е невидим.
When the solid region is Board Cutout, please set the layer to Multi-Layer. =
You should not try to assign a net to a Board Cutout solid region. =
Net Length =
You can place a Pin in the schematic, but don't forget to group all of the Pins to a schematic component. Please click the help button to find out how to group them. If you just want to mark the wire, please use NetPort or NetLabel. =
Please input the modification =
The content must be between {0} and {1} characters =

Coming soon = Очаквайте скоро
No tool = Без инструмент
Help us translate into your language = Помогнете ни да го преведем на вашия език.
Pad = Площадка
Via/Hole = Проходник/отвор
PCB Layers = Слоеве на печатна платка
Order PCB = Поръчка на печатна платка
Share = Споделяне
Free = Свободни
Small = Малък
Medium = Среден
Big = Голям


Embed =
HTML =
URL =
BBCode =
PNG =
Exporting as =
Exporting as image =
Exporting as {0}SVG{1} file. =
Exporting as pdf is recommended: pdf gives good quality printed output and a small file size. =
Generate PCB Fabrication File(Gerber) =
PenWidth-Increase =

#Generate Gerber
Generate Gerber =
Gerber View =
Dimensions(Estimated) =
PCB Qty =
Copper Weight =
PCB Price =
Estimated Delivery Time =

HASL(with lead) =
LeadFree HASL-RoHS =
ENIG-RoHS =
Would you like to do Design Rule Checking (DRC) before generating the Gerber files? =
Yes, Check DRC =
No, Generate Gerber =
This PCB has uncompleted connection(s), do you want to check the connection(s)? =
Yes, Check Connection(s) =
It will then redirect to the web site of a third-party JLCPCB with which we cooperate. Are you ready? =
Failed to submit your order, please contact us via support@easyeda.com for help. =
Failed to submit your order, please contact us via QQ 800821856. =
Order data generated finish, please click OK button and continue. =
[generateGerber]
Layers =
[/generateGerber]

[version]
Switch =
[/version]


Export your file, then print it yourself. =
Trace width is too small =
Share =

Images Property =
Connect Pad to Pad =
Copper Area =
Dimension =


Please check that you have used Wire and not Line to connect electrical elements. =
PCB Fabrication Prices & capabilities =
Flip all texts on bottom layer =
Create New Document =
General Package =
General Packages =
favorite Package =
Board Cutout =
Surface Mount =
JLCPCB Part Class =
base =
expand =
recommend =
Basic Part =
Extended Part =
Recommended Part =
smtWeld =
thtWeld =
manualWeld =
furnaceWeld =
Multi-Layer =
Markdown Syntax =
Markdown supported =
Read only =
Read/Write =
More Libraries... = Още библиотеки...
Decompress failed! =
Load failed! =
Loading =
No Result =

#Dialog Place Pin in schematic warning
Place Pin in schematic warning =
You can place a Pin in schematic, but don't forget to group all of the Pins to a schematic component, please click the help button to find out how to group them. If you just want to mark the wire, please use NetPort or NetNabel. =
I know. Do not show this again. =

#Extensions Setting
Extensions Setting =
Remove =
Disable =
Enable =
(Disabled) =
(Enabled) =
Load Extension =
Enable or disable will be applied after reload page =
Your browser cannot run this function. =
Your browser mode does not support indexedDB. Some features may not work properly. Are you using Private Browsing Mode? =
Extension Files =
Extension ID =
Select Files =

#Scripts
Script =
Scripts =
Script Content =
Load from js file =
UTF-8 encoded js file =
Description =
description =
Not a *.js file =
Failed to read file =
System scripts cannot be modified =
Create Subfolder =
Create Script =
Install Script =
Install =
Desktop Client =
Are you sure you want to remove this script? =
Folder Name =
Rename =
Please select a script =
Failed to load script =
Run Script =
Load Script =
Title is required =
Script content is required =
System Scripts =
User Scripts =
You can right click on the tree nodes. =

#PCB photoView toolbar
Top Side =
Bottom Side =
With Silk Layer =
No Silk Layer =
Photo View =

#check update
Check Update =
EasyEDA Editor {ver} is released. Would you like to switch to the new version now? =
LCEDA Editor {ver} is released. Would you like to switch to the new version now? =
Switch to New Version =
Next Time =

#download project dialog
Generating download link... =
Download project now =

#Import DXF
Import DXF =
Apply Unit =
Convert circle to HOLE on BoardOutLine layer =
No shapes found =
Fail to load the file =
Please select a DXF file. =
This feature only works for PCB document. =
Select a DXF file =

#Export DXF
Export DXF =
Plated-Through-Hole Pads =
Non-Plated-Through-Hole Pads =
Silkscreen =
Surface Pad =

#Data Sync
Data Sync =
Data Conflicts =
Project or Document =
Cloud-Side =
Local-Side =
Decision =
Modified =
Deleted =
As Cloud =
As Local =
Skip =
Data sync completed =

#Team
Team =
Teams =
Switching team =
Switch team failed =
Load team info fail! =
Load team info fail! Please reload. =
My Teams =
Create Team =

#Dialog Footprint Manager
Footprint Manager =
Open Footprint Manager =
Schematic Components =
Edit Pin Map Information =
Package Categories =
Components List =
Personal =
Component PIN information =
Footprint PAD information =
Footprint Categories =
Pad Number =
Search Footprint =
Select Footprint =
Search 3D Model =
Select 3D Model =
Filter by keyword =
System Libs =

#dialog global delete
Drawings =
Netlabel and netFlag =
Texts =
Wires =
Board outlines =
Footprints =
Footprint =
Tracks =

#dialog board outline settings
Current Size =
Paramenters =
Start X: =
Start Y: =
Round Rectangular =
radius =
only number is allowed! =
please input valid value of width! =
please input valid value of height! =
please input valid value of radius! =

#cross probe
The object you selected was not found in other documents. =
No valid object for cross probe selected. =
Can not probe. Refreshing the window may get it to work. =
You need to login for this function to work. =

#About Dialog
An Easier EDA Experience =
Version =
BuiltDate =

#Auto Router Dialog
Auto Router Config =
General Options =
All Layers =
Configure =
Sorry, your web browser does not support this feature. Please run a modern browser. =
Please make sure all objects with net are inside the board outline! =
Cannot start again before previous activity is stopped =
Please select a net =
TrackWidth cannot be empty =
Clearance cannot be empty =
Router is time out. =
Server is busy, please try again later. =
Due to the limitation of {0}router server{1} resources, multiple routers executing concurrently are not supported, please try again later or do it manually :-) =
Track Width is invalid =
General Clearance is invalid =
SMD Clearance is invalid =
Diameter is invalid =
Drill Diameter is invalid =
Track width cannot be less than Design Rule Checking (DRC) setting value. =
General Clearance cannot be less than Design Rule Checking (DRC) setting value. =
SMD Clearance cannot be less than Design Rule Checking (DRC) setting value. =
Hole size cannot be less than Design Rule Checking (DRC) setting value. =
Design Rule's via diameter must be larger than via drill diameter =
Clearance cannot be less than Design Rule Checking (DRC) setting value. =
Not a valid PCB, please check it again =
Previous connection must be closed =
Network error. Please try again. =
Router error. =
Invalid PCB. =
General Clearance =
SMD Clearance =
#Ripup Nets =
Skip Routed Nets =
Remove Existing Tracks =
Real-time Display =
Router Layers =
Via =
Special =
Special Nets =
Skip Nets =
Router Server =
Local =
Cloud =
Available =
Unavailable =
Checking =
Install Local Auto Router =
Checking local auto router server... =
Stop Router =
Auto Router is running... =

#Left Siderbar
Commonly Library =
Basic =
Extend =
Design Manager =
Library =
Spice Library =
Shared =
LCSC =
LCSC Parts =
Supply Flag =
US =
EU/IEC =
US Style =
Resistor =
Capacitor =
Inductor =
Switch/Key =
EU/IEC Style =
CN =
Connector =
Switch/Relay =
JLCPCB =
Recycle Bin =

#Protractor
Font Height =
Precision =
Protractor =

#attr-pcbtext-line-width
Only default font family supports to change font width. =
Font is missing! You can confirm the dialog and use default font instead or cancel the dialog then upload your font and do it again. =

#Common
Owner =
License =
Part Pins =
Part Properties =
Net Pins =
Net Ratlines =
Add Parameter =
Histories record =
Create Team =
Can't find this footprint on the server, please re-associate it. =
The footprint name associated with the component and the footprint name on the server are inconsistent, please re-associate it. =
The symbol pin number(s) of the component does not match the associated footprint pad number(s), please modify the symbol pin number(s) or re-associate the footprint =
No footprint, please associate the footprint first. =
Can't find the package =
The path is for the project URL identify, it is unique (the identity of the project owned by the user cannot be the same) =
It's with a letter or a number and can contain only numbers, letters, line-through, underscores, and points. It cannot be modified after saving. =
Updating document to new format, please wait......After finishing please save your document with Ctrl + S. =
Open at current project? =
Please select a history to recover. =
Be careful! When you click the "Recover" button, this sheet will be overwritten! =
Recover =
There is no PCB under this project, would you like to create one? =
Please make sure that the chose Altium Designer files are saved as ASCII files. =
Export to Altium function is currently in beta: =
1. Please be sure to read the notice before exporting: =
Export Altium notice and disclaimer =
2. Please be sure to check again after export! =
I have read and agree =
Export to Altium =
Please make sure that the chose Eagle files are saved in Eagle v6.0 and above. =
Please make sure that the Kicad files were compressed as the .zip file. =
Open Altium Designer file =
The more information please refer at : =
Please use Gerber file instead of exporting Altium if you are going to do PCB manufacturing. All PCB factories support the Gerber file. Is it ok to Generate the Gerber file? =
Yes, Generate Gerber =
No, Export Altium =
Open Eagle file =
Open Kicad file =
Select file(s) =
Append to current project? =
Append =
Open as new project =
Tip: Press {0}SPACE{1} or {2}R{3} to rotate the placing object or selected object. =
Hotkeys Setting =
I know. Don't show this again. =
Manufacturer Part Number can not be less than 2 characters. =
This prefix was changed to non-subpart format. =
Save as New Project =
Save to Existing Project =
Sheet Setting =
Sheet Size =
Pre =
pre =
Invalid Data =
Others =
You are not authorized to share this project. =
This project is private: if you continue sharing it will be made public. =
Modify file info =
Please input search keyword =
Sort Projects by =
Date Created =
Date Modified =
Title =
Ascending =
Descending =
Pin to Top =
Unpin from Top =
Collapse / Expand =
Expand =
Expand All =
Collapse =
Collapse All =
Your file hasn't been saved, do you want to save it? =
Don't Save =
Library Owner: =
verifyPkg.Value =
State =
Please select! =
Route =
Import successfully: =
Import failed: =
Path only contain 'a-z、A-Z、- 、 _ 、0-9'! =
Path must begin as 'a-z、A-Z、0-9'! =
The path length must be between 4~128 characters! =
The title length must be between 2 ~ 128 characters. =
Please select an owner =
Please select obj, wrl or zip file. =
Do you want to delete this file? =
Add sub part success =
Please input name and prefix! = Моля въведете име и представка!
Board outlines are not closed =
Import failed! The imported files were not ASCII format, please save the files as "Advanced Schematic ascii(*.SchDoc)" or"PCB ASCII File(*.PcbDoc)" at Altium Designer first, and then import. =
The Pins "{0}" are not snapped on the grid point! This part maybe will cause some errors in the schematic. =
Save failed! Pin number doesn't allow repeat! As below pin number repeat: {0} =
Check Pin =
Failed to read {0} =
{0} is invalid =
{0} not found =
Failed to execute script: =
One or more js files not found =
Only ONE {0} file is required =
Extension ID is required =
Extension ID is invalid =
Extension ID is duplicated =
No Result! =
Load Error =
loading =
Failed to load spice data =
Netlist =
Tags =
Pin Information: =
Format incorrect, please check for the extra spaces or commas! =
Round Radius =
Keyword: =
Image =
Image copied. =
Copy failed. =
Copy success. =
Image Property =
Locked =
Unlock All =
Unlock =
Lock =
Please input pin name and pin number! =
Left-Hand Panel =
Right-Hand Panel =
Update Components from Library =
The pin number(s) can't find the same pad number(s) =
Designator =
Replace =
Update failed =
Successfully updated =
Update failed! =
Successfully updated! =
Successfully updated {0} component(s)! =
Change =
Check Footprints =
Network Error! =
Find Similar Objects =
Current Sheet =
All Sheets =
Kind =
Range =
Net Label/Net Flag/Net Port/Voltage Probe =
Bezier/Freehand Draw =
Arc/Pie =
Objects Properties =
Any =
Same =
Different =
Circular =
Expose Copper =
"{0}" font is missing. Please add the font to the font family list. =
Place Component =
Delete Segment =
Angle =
Board Thickness =
Layer Distance =
Silk Screen =
Surface Finish Color =
Colors =
Board Color =
Board Side =
Silk Screen =
Silk Screen Color =
Display =

#Array and Clone
Distribute Array =
Array Type =
Matrix Array =
Circular Array =
Item Rotation =
Location =
Items per Column =
Items per Row =
#Column Spacing =
#Row Spacing =
Spacing(Degrees) =
Start Degree =
Rotate Item to Match =
Clockwise =
Anti-Clockwise =
Distribute by =
Column =
Row =
Array Clone =
Number of Rows =
Number of Columns =
Number of Copies =
Distribute Range(Degrees) =

#Theme color dialog
BusEntry =
Foreground =
Common Used =
Original Theme =
Theme Setting =
Change the theme colors of your design =
White on Black =
Black on White =
Custom Theme =
Color Setting =
Apply Setting =
Theme Setting... =
Bus Entry =
Foreground =
Symbol Graphics =
Common Used =
Draw =
Sheet =
The original theme only works for placing the new symbols. =
Selection Highlight =
Net Label / Port =

My Theme = Моята тема
My Theme Settings = Настройки на моята тема
Apply 'Custom Theme' On = Приложете включване на 'Персонализирана тема'
Creating New Schematic = Създаване на нова схема
Opening Existed Schematic =
Please fill in all parameters! =
Convert to Board Cutout =
Prefix Position = Позиция на представка
Name Position =
Center =
Top =
Bottom =
Left =
Right =
Does not support multiple objects to convert to Board Cutout at the same time =
Does not support multiple objects to convert to pad at the same time =
Convert to Board Cutout =
Convert to Pad =
Convert to Component Shape =
Combine to Continuous Track =
Convert to Solid Region =
Substrate =
3D View =
2D View =
Pin Color =
Name Color =
Number Color =
Dot =

[theme]
Sheet =
[/theme]


#history dialog
[history-dlg]
Number =
Editor =
[/history-dlg]
View File History =
Save Time =

Invalid Format =

#Dialog Teardrop
Round Pad / Via =
Rectangle / Oval / Polygon Pad =
Applying Teardrops =
Removing Teardrops =
Waiting =
Progressing... =

No schematic in the project! =

Move Forward =
Move Backward =

#Dialog Panelize
V-CUT = скрайбиране //прорез
Stamp Hole =
No Panelize =
Border and Marking =
Create Border =
Border Height =
Border Position =
Create Positioning Holes =
Create Fiducial Marks =
Top and Bottom =
Left and Right =
Stamp Hole Group - Column =
Stamp Hole Group - Row =
The number of rows and columns cannot be set to 1 simultaneously =

#edit path point
[editPathPoints-dlg]
Arc(R) =
Type =
Action =
add before =
add after =
delete =
[/editPathPoints-dlg]

#edit polygon point
[editPolygonPoints-dlg]
Action =
add before =
add after =
delete =
[/editPolygonPoints-dlg]
You have unconfirmed edit! =
Invalid edit! =

#Dialog PCB Information
PCB Information... = Информация за печатна платка
Signal Layers = Сигнални слоеве
None Signal Layers = Нито един от сигналните слоеве
Pads = Площадки
Surface Pads = Повърхностни площадки
Plated Through-hole Pads = Проходни площадки с метализация
None Plated Through-hole Pads = Проходни площадки без метализация
Holes = Отвори
Vias = Проходници
Length of Tracks = Дължина на пътечки
Copper Areas = Медни площадки

#Differential Pair Routing
Differential Pair Routing =
Differential Pair Rule Setting =
Please input track width =
Please input clearance =
Routing Rules =

#Route Length Tuning
Track Length Tuning... =
Tracks with different net or non-track found in current targets. =
Please select the signal tracks to be tuning. =
The total length exceeds the Design Rule Checking (DRC) constraint, continue ? =
45° Angle =
90° Angle =
DRC Track Length : =
Current Length : =
Additional Length : =
Target Length: =
Current Length: =
Adjust Type =
Double Side =
Single Side =

can not connect to the server =

#Dialog Copper Area Manager
Copper Area Manager... =
Copper Area Manager =
Order =
Name =
Layer =
Color =
Net =
Move Up =
Move Down =
Apply =
Cancel =
Copper Area do not allow self-intersection! =
No copper area! =
#Dialog report error
Datasheet =
Verification =
Symbol =
Pad Number =
Pad Size =
Remark =
Correct =
Incorrect =
Submit =
Tip =
Please select one component =
Location X =
Location Y =
Your current browser version may not support some features. Please use the latest version of Chrome or Firefox, or try the desktop client. =
EasyEDA Client =
LCEDA Client =
Chrome =
FireFox =
New Version =
Switch Version =
Members =
Update Time =
Editor =
Current Version =
Latest Version =
Please select a different version to switch; If you want to edit different version in the same time, please open them in different browsers. =
3D Model =
Board Side =
Display =
Copper =
Create New Version =
Create new version success! =
Version Management =
Switch success! =
Please close current version's documents first! =
Creator =
Create Time =
Fail to connect to server! Please check your internet connection status and try again! =
Spice Number =
Create =
3D Outline =
Cannot create the slot hole via the board outline, please use the following methods: =
Use the solid region and set its type as Board Cutout =
Select a Track/Arc, right-click to use the "Convert to Board Cutout" =
Select all the closed Tracks/Arcs, right-click to use the "Convert to Board Cutout" =
The more information please refer at =
Save "{0}" success! =
Save "{0}" failed! =
Invalid Size =
Processing =
Invalid Size =
NetFlag GND =
NetFlag VCC =
NetFlag +5v =
No Useful Data! =
SVG Preview =
Prefix contains not supported charater(s) ! = Представката съдържа неподдържани символи
Name contains not supported charater(s) ! = Името съдържа неподдържани символи
Create Grid Path =
Please Input Name =
Building Copper Area =
Processing =
Opening File =
Update from Library =
Update Footprint =
Update 3D Model =
Find footprint(s) have been updated, do you want to update? =
3D File: =
Model List =
Are you sure merge net {0} and net {1}? =
Display Footprint =
Display Footprint Name While Placing Component =
Annotate Prefix Automatically After Placing Component = Добавяне на бележка към представката, автоматично след поставяне на компонента
Program Error, Please Contact Technical Support! = Програмна грешка, моля свържете се с техническата поддръжка!
Search Engine =
Keyword to Filter =
Normal Mode =
Expand Mode =
3D Model Manager =
3D Model Preview =
3D Model =
3DModel =
Document =

[pcblayer]
3DModel =
Document =
[/pcblayer]

Adjustment =
View Larger Image =
Previous =
Previous Image =
Next Image =
Notice: For reference only, please refer to the real product =
It's under designing, please wait. =
The width of track/arc/circle cannot be less than 0.1mil! =
Clone success ! =
Footprint Naming Reference =
3D Model Manager =
Will jump to the Lichuang open source hardware platform (OSHWHub.com) to improve the information and share. Whether to continue? =
Will jump to the EasyEDA open source hardware platform (OSHWLab.com) to improve the information and share. Whether to continue? =
The project content page will open. After adding a description and setting the project to public, you can click the share button to get the share link. =
This project is not public, can not view homepage! =

[grid]
None = Нито едно
[/grid]

#lib verify and mounted
This component is verified =
This component is unmounted =

#find component
Find Next =
Pin not found =
Pad not found =
Object not found =

#offset Elements
Offset X =
Offset Y =
Offset =
Absolute Offset =
Relative Offset =
Absolute Offset... =
Relative Offset... =
Reference Point X =
Reference Point Y =

#Inner Plane layer
Rebuild Plane =
PlaneZone Properties =
Change to a plane layer is not allowed during track routing. =
#pcblib rect
Fill =
Fill Type =
[PlaneZone]
Solid =
[/PlaneZone]

Solid Region do not allow self-intersection! =

The prefix or name or text too far away from the footprint, if you don't want it to show up please make it hidden. = Представката или името, или текстът е твърде отдалечен от отпечатъкът, ако желаете да не се вижда, моля скрийте го.
The prefixes are not allowed to repeat! = Не е позволено да се потварят представките!
Save failed! The origin of the canvas is not in the graphics! Whether to set the origin automatically? =
The origin of the canvas has been set in the graphics now, you can save again. =
Backup Project =
Open Project Directory =

{0} items updated =

The current file {0} has an updated version. Do you want to overwrite it? If you want to open the latest version, please close the current file and reopen it. =
Yes, Overwrite It =
No, Keep It =

Download Client =

Search tutorial、open source projects etc. =

Go to LCSC and search for =
Go to LCSC =

Hide Ratline Layer and Keep the Component Prefix When Paste Objects =

ALL.layer =
Copper.layer =
Non-Copper.layer =
Other.layer =

Please enter at least 2 characters! =
View Datasheet =
View Datasheet... =

The corresponding package or network could not be found in the currently open PCB document =
delete fail =

[crashRecovery]
Libraries = Библиотеки
[/crashRecovery]
Canvas origin anomaly! =

Component's Name = Име на компонента
Component's Prefix = Представка на компонента
Component's Footprint = Отпечатък на компонента

[findlib]
Clear = Изчистване
Apply Filters = Прилагане на филтрите
Result = Резултат
Place = Поставяне
Prev = Предишен
Next = Следващ
Total {count} Count = Общо {count} броя
About = Относно
Items = Обекти
[/findlib]

Object = Обект
Layers and Objects = Слоеве и обекти
All = Всичко

Add custom =

Connections =
Attempted: =
Completed: =
Failed: =
Total Vias: =

Please confirm moving option =
Only this pad =
For this component =
View Owner =
View Detail =


#place batch vias
Place Vias =
Placing Vias =
Removing Vias =
Batch Vias for Copper =
Add/Remove Vias =
Diameter =
Drill Diameter =
Column Spacing =
Row Spacing =
Multiple vias have been placed, do you want to rebuild the copper area? =
Remove vias finish, do you want to rebuild the copper area? =
The width of track/arc/circle cannot be less than 0.051mm/2mil/0.002inch! =
Save fail! Please try again! =
Please select a copper outline =
Can't find copper area at other layers, please add the copper area with the same net at other layer first. =

Add favorite success! =
Remove favorite success! =
Remove favorite failed! =
Whether if remove favorite? =
Split by ';' for multi tags =

This size is the determined size! =
The associated pad has been locked =
Split by space or , for multi tags =

Rotation X =
Rotation Y =
Rotation Z =

Some fields are filled invalid data =
start time should be earlier than stop time =
Number of points should be less than 100 in octave variation =
Start frequency should be less than stop frequency. The suffix meg stands for Mega,m stands for milli =
Get historical records fail! =
This 3D model didn't create the outlines successfully, please import it again or contact with us. =
There is No Tag! =
Assign successful! =
Found footprint's pad number doesn't match the schematic component's pin number, please correct the pad number and try again! =
Update Property =
Update Properties =
Please fill in at least 5 words. =
Mouse hovering over the track to highlight the entire network =
Net Highlighting While Cursor Hover the Track =
When circle set as "Yes", the Pin length must be more than 6 =
Hi, I found a problem of your library, this library seems incorrect.\ntitle:{title}\nType:{type}\nlink:{link}\n{content}\nThank you! =

Logout fail! Please try again! =
Logout success! We look forward you to use LCEDA again! =
Logout success! We look forward you to use EasyEDA again! =
Click to Preview 3D =
[logoutDialog]
Logout =
[/logoutDialog]

[findlibTag]
All =
[/findlibTag]

Export Pick and Place File = Извличане на Pick and Place
Mirror the bottom component's X coordinate (JLCPCB doesn't need) =
Work Space = Работно пространство
Include panelized components' coordinates = Включване на координатите на компоненти от панелизацията
Personal Workspace = Лично работно пространство
Work Space - {name} = Работно пространство - {name}
Work Space - Personal = Работно пространство - Лично
Cloning = Клониране

Project Owner = Водещ проектант
Clone Project = Клониране на проект
Homepage = Начална страница
Apply for Education Edition = Кандидатствай за учебна версия
Load Organization failed = Провалено зареждане на организацията
Joined =
Favorite = Любими
This operation will unfavorite this project, do you want to continue? = Това действие ще премахне проектът от любими, желаете ли да продължите?
View Homepage = Вижте началната страница
Private Project = Лични проекти
3-7 days = 3-7 дни
Close Tab = Затваряне на раздел
Close Other Tabs = Затваряне на други раздели
Close All Tabs = Затваряне на всички раздели
Open in New Window = Отваряне в нов прозорец
Cursor Snap to Component's Origin or Pad Center While Dragging Component =
Undefined = Недефиниран
Input = Вход //или Въвеждане, в зависимост от контекста
Model Unit = Мерна единица на модела
File Unit = Мерна единица на файла
This part contains subparts, please make sure you have checked other subparts before reporting error, do you want to continue? = Този част съдържа подчасти, моля уверете се, че сте проверили другите подчасти, преди да съобщите за грешка, желаете ли да продължите?

[saveAs]
Power = Мощност
[/saveAs]

Assign LCSC Part# =
Unexpected error while converting. Perhaps unsupported file type or program bug. =
Found duplicated component IDs, please click "OK" to re-assign component ID automatically, and then save the document and try again. =

#electromagneticSimulation
Electromagnetic Simulation... = Електромагнитна симулация
You will upload Gerber to SuperEM for electromagnetic simulation (only upload Gerber, not including account data), do you want to continue? =
SuperEM is a 3-D full-wave electromagnetic simulation and design platform for high-speed PCB circuits and antennas, which is developed by Faraday Dynamics, Ltd. =
Visit the SuperEM =
SuperEM User Guide =
Upload Gerber to SuperEM successfully, please click "OK" buttun to continue =

Format = Форматиране
View = Изглед
Design = Проект
Simulation = Симулация
Advanced = Разширени
Fabrication = Производство
Check DRC = Проверка на DRC
Simulation Setting = Настройки за симулация
BOM = Спецификация на материалите
PCB Fabrication File(Gerber) = Файл за производство на печатна платка (Gerber)
Pick and Place File = Файл за машинно насищане
Parts Order = Поръчка на компоненти
PCB Order = Поръчка на печатна платка
One-click Order Parts = Поръчка на компоненти с едно натискане
One-click Order PCB/SMT = Поръчка на платка/компоненти за повърхностен монтаж с едно натискане
SIM =
STD =
WaveForm = Осцилограма

Place Module = Поставяне на модул
Please enter identification letters: = Моля въведете иденфикационни символи:
Only support English letters, up to 5. = Поддържа само Латински символи, до 5 броя.

Exist doesn't annotate prefix component(s) in the module, please edit and annotate the unique prefix(s) for component(s) first. =
Opening =

Also update track's net (Only applies to circumstance under which prefix/netlabel changes and no component/wire is added or removed) =

#desktop client error feedback
Cannot open online documents on Project Offline mode. =

Please select a project = Моля изберете проект
Opened Projects = Отворени проекти
Open Project = Отваряне на проект
Close Project = Затваряне на проект
Open All Projects = Отваряне на всички проекти
Close All Projects = Затваряне на всички проекти
Select Owner = Избор на собственик
Select Folder = Избор на папка
Select Owner or Folder = Избор на собственик или на папка
Select Project = Избор на проект
Folder = Папка
New Folder = Нова папка
New Sub Folder = Нова подпапка
Delete Folder = Изтриване на папка
Move Project = Преместване на проект
Move Folder = Преместване на папка
#Rename Folder
Please input the folder name = Моля въведете име на папка
Invalid folder name = Невалидно име на папка
Are you sure to delete this folder? = Сигурни ли сте, че желаете да изтриете тази папка?
All projects in this folder will be moved to the root directory. = Всички проекти в тази папка ще бъдат преместени в основната директория.
Create new folder successfully = Създаването на нова папка е успешно.
Failed to create new folder = Неуспешно създаване на нова папка.
Delete folder successfully = Изтриването на папката е успешно.
Failed to delete folder = Неуспешно изтриване на папката.
Rename folder successfully = Преименуването на папката е успешно.
Failed to rename folder = Неуспешно преименуване на папката.
Move folder successfully = Преместването на папката е успешно.
Failed to move folder = Неуспешно преместване на папката.
Move project successfully = Прместването на проекта е успешно.
Failed to move project = Неуспешно преместване на проекта.
The folder depth must not exceed {0} levels = Дълбочината на папката не може да надвишава {0} нива
Failed to add project to folder = Неуспешно добавяне на проекта към папката.

Doesn't support JLCPCB SMT Service = Не се поддържа JLCPCB SMT обслужване.
{0} for JLCPCB SMT Service = {0} за JLCPCB SMT обслужване

Reset failed! There are duplicate component prefixes in the current schematic: = Нулирането е неуспешно! Има дублиране на представки на компоненти в текущата схема:
Reset failed! There are duplicate component prefixes in the current PCB: = Нулирането е неуспешно! Има дублиране на представки на компоненти в текущата печатна платка:
Please modify the component prefixes first to ensure that the component prefix is unique. = Моля променете представките на компонентите за да осигурите уникалност на представките.

LCEDA(Standard) - A Simple and Powerful Electronic Circuit Design Tool =
EasyEDA(Standard) - A Simple and Powerful Electronic Circuit Design Tool =

#Dialog for Package Custom Data
Please input the data title =
Data title duplicated =
Cannot be more than {0} characters! =
Only latin alphabets, digits, underscore(_) and hyphen(-) are allowed. =
Invalid value of item {0} =
Update DFM =
Custom DFM Data =
Saved custom data successfully! =
Save custom data failed! =
Will replace the graphics and custom data of current document, after imported please adjust the 3D model. Continue or not? =
Open footprint "Custom Data" dialog =

#Create lead shape
Create Lead Shape =
Base on Pad Center =
Base on Canvas Origin =
Lead shape =
Footprint Type =
From pad shape =
Lead length =
Lead width =
Lead diameter =
Scaling ratio =
Leads creating direction =
Auto =
Horizontal =
Vertical =
Canvas origin to lead edge = Начало на чертожното поле по водещ ръб
Canvas origin to body edge = Начало на чертожното поле по ръба на тялото
Lead soldering length = Дължина на извод за запояване
Lead soldering part diameter = Диаметър на извод за запояване
Component shape object doesn't overlap lead shape object, please check carefully. =
The solder mask expansion of pads ({0},{1}) has a small clearance(less than 0.08mm), it will cause the soldering too short, please modify. =
The paste mask expansion or custom paste mask layer objects of pads ({0},{1}) has a small clearance(less than 0.15mm), it will cause the stencil to create fail, please modify. =
System footprint must have pad number 1 or A1, please modify the pad number. =
System footprint doesn't allow two or more pad numbers are 1 or A1, please modify the pad number. =
Document layer has circle object, but jlcPara's polarity is 0, please check the Custom Data. =
There are exist repeat pad numbers: {padNumber}, please check, if it is correct please ignore this. =
Can't find the circle at the component marking layer, or this circle doesn't at the same quadrant with the 1st pad, please check whether it is correct. =

ROUND =
RECTANGLE =
OCTAGONAL =
Upper left =
Lower left =
Center of Pads =
First Pin =
Package Name =
Pins Number =
Rows Of Pin =
Columns Of Pin =
Polarity =
Pad Shape =
Body Diameter =
Lead Span =
Lead Vertical Span =
Body Length =
Body Height =
Pin Diameter =
Pin Length =
Pin Height =
Pin Solid Width =
Pin Solid Height =
Pin Spacing =
Pin Horizontal Spacing =
Pin Vertical Spacing =
ThermalPad =
Pad Expansion =
Custom PasteMask =
Fabrication Tolerance =
Placement Tolerance =
FirstPin Position =
Package Origin =
Expansion Size =
Corner =
Angle =
Fillet =
Chamfer =
Update Preview =
Number of pins (left and right) =
Number of pins (up and down) =
Reference Use Cases =
Package Type = Тип на корпуса
Capacitance = Капацитет
Resistance = Съпротивление
Bidirectional Diode = Двупосочен диод
Inductance = Индуктивност
Crystal Oscillator = Кристален генератор
Diode = Диод
LED = Светодиод
Fuse = Предпазител
Entity height =
Lead Overhang =
Lead Thickness =
Unknown mistake = Неизвестна грешка
Has ThermalVias =
Polar Capacitance = Полярен кондензатор

Create Component Marking =
Create component marking successfully! =
No elements on component shape layer! =
No elements on lead shape layer! =
No pad of number 1 or A1, please modify the pad number. =
Save failed! Component marking circle is at the axis. Do you want to recreate the component marking? =
If autoroute fail, you can export the autoroute file(DSN) to third-party autorouter tool(Such as: FreeRouting, Konekt Electra, Eremex TopoR etc.), and export the session file(SES) after finished autoroute, and then import to PCB. =
Auto route failed! Found abnormal pad(s) data, please modify the pad width and height: =
Select Properties =
Combine the same parts' prefixes in one row = Комбинация на еднаквите представки на компонентите, в един ред
Please check at least one item! =
Pins =
Check component latest version when open schematic =
Only show updated components =
Note: When a PCB is Import Changes, the PCB is updated according to the footprint version to which the schematic is bound. =
Doesn't support to import the binary format DXF, please import the ASCII format DXF. =

Find System Similar Footprint =
Found similar footprints at system library, it is recommended to use them first. =
Copy Title =
Check system similar footprint =
Can't find the Similar Footprint =
Search failed! =
No package information! =
Find Parameters =
Find Results =

Bill of material(BOM) uploaded finish, please click "OK" to continue. = 
Bill of material(BOM) upload failed! = 

All pads = Всички площадки
All holes = Всички отвори
Single layer pads = Еднослойни площадки
Multi-layer pads = Многослойни площадки
Same X pads =
Same Y pads =
Same Y and clearance pads =
Same X and clearance pads =
Same X and clearance pads' clearance =
Same Y and clearance pads' clearance =
Pad's hole diameter(max) = Диаметър(max) на отвора в площадката
Pad's hole diameter(min) = Диаметър(min) на отвора в площадката
Pad's hole diameter(aver) = Диаметър(aver) на отвора в площадката

Try Pro Edition = Опитай професионалната версия

Generate Solid Region by Objects Outline = Генериране на плътен регион, според очертанията на обектите
Generate Polygon Pad by Objects Outline = Генериране на полигонна площадка, според очертанията на обектите
Select the objects that cannot be generated = Избиране на обектите, които не могат да бъдат генерирани

Please compress schematic and PCB as a zip file and then import it, if you only import the schematic you need to binding with the footprint manually. = Моля компресирайте схемата и печатната платка, във zip файл и тогава го вмъкнете. Ако вмъкнете само схемата, ще е необходимо ръчно обвързване с отпечатъка.
Please compress schematic and PCB in ASCII format as a zip file and then import it, if you only import the schematic you need to binding with the footprint manually. = Моля компресирайте в zip файл схемата и печатната платка, която е в ASCII формат и тогава я вмъкнете. Ако само вмъкнете схемата, ще е необходимо ръчно да се обвърже с отпечатъка.
Import failed! The imported files were not ASCII format, please save the files as "Advanced Schematic ascii(*.SchDoc)" or"PCB ASCII File(*.PcbDoc)" at Altium Designer first, and then import. = 
The PCB text will use the editor new font family, the text maybe will appear a little excursion. = 
Because of different file format and element, please check carefully after imported. = 
Please make sure the EAGLE file is saved in EAGLE v6.0 and higher version. = 
Please compress schematic and PCB as a zip file by KiCad5 and then import it, if you only import the schematic you need to binding with the footprint manually. = 
Please make sure the Protel file is exported as ASCII format file. = 
Please compress the schematic and corresponding symbols as a zip file and then import it. = 

Please save the files as "Advanced Schematic ascii(*.SchDoc)" or"PCB ASCII File(*.PcbDoc)" at Altium Designer first, and then import. = 
Tips = Съвети
Exists incomplete connection = Съществува непълна връзка
Found that the board has incomplete connection, please check the nets and ratlines = 
creator = 
You are not logged in or the login status is invalid, please login and try again. = 
Display Board Cutout = 
