# Menu
User = Usuário
Join... = Registrar...
Login... = Conectar...
Log in = Conectar
Logout = Desconectar
Change password... = Trocar senha...
User Preference = Preferências de usuário
System Settings... = Configurações do sistema...
System Settings = Configurações do sistema
Crash = Pane
Invite friends... = Convidar amigos...
Language = Idioma
Language Setting = Configuração de idioma

Document Recovery = Recuperação de documentos
Your Preferences Information = Suas informações de preferência
File = Arquivo
New = Novo
Project... = Projeto...
Schematic = Esquemático
Schematic-Simulation =
Spice Symbol = Símbolo Spice
Spice Subckt = Spice Subckt
spicePre =
PCB = PCB
Schematic Module = Módulo Esquemático
PCB Module = Módulo PCB
Save... = Salvar…
Save As... = Salvar como…
Save As Module... = Salvar módulo como…
Print = Imprimir
Export Document = Exportar Documento
LTspice... = Ltspice…
Eagle... = Eagle…
Altium... = Altium…
Cadence... = Cadence…
Pads... = Pads…
DXF = DXF
Import = Importar

Edit = Editar
Undo = Desfazer
Redo = Refazer
Cut = Cortar
Copy = Copiar
Paste = Colar
Select = Selecionar
Delete = Deletar
Clear All = Limpar Todos
Move = Mover
Drag = Arrastar
Bring to Front = Trazer para Frente
Send to Back = Mover para Trás
Align = Alinhar
Align Left = Alinhar à Esquerda
Align Right = Alinhar à Direita
Align Top = Alinhar ao Topo
Align Bottom = Alinhar à Base
Align Horizontal Centers = Alinhar Centros Horizontais
Align Vertical Centers = Alinhar Centros Verticais
Distribute Horizontally = Distribuir Horizontalmente
Distribute Vertically = Distribuir Verticalmente
Distribute Left Edges Equidistantly = Distribuir Bordas Esquerda Equidistantemente
Distribute Top Edges Equidistantly = Distribuir Bordas Superiores Equidistantemente
Align Grid = Alinhar Grade
Rotate = Rotacionar
Rotate Left = Rotacionar à Esquerda
Rotate Right = Rotacionar à Direita
Flip Horizontal = Inverter Horizontal
Flip Vertical = Inverter Vertical
Rotate and Flip = Rotacionar e Inverter
Group/Ungroup Symbol... = Agrupar/Desagrupar Símbolos...

[menu_project]
View = Visualizar
[/menu_project]
Find = Encontrar
Zoom In = Mais Zoom
Zoom Out = Menos Zoom
Fit in Window = Caber na Janela
Refresh = Atualizar
Snap = Encaixar
Cross Cursor = Cursor Cruzado
Toolbars = Barra de Ferramentas
Drawing Tools = Ferramentas de Desenho
Wiring Tools = Ferramentas de Ligação
Power Objects = Power Objects
PCB Tools = Ferramentas PCB
Footprint Tools =
Layers Tool = Ferramenta de Camadas
Layer Manager = Gerenciador de Camadas
Enable and Show All Layers = Habilitar e Mostrar Todas as Camadas
Net Visible = Net Visível
Auto = Auto
Digital Objects = Objetos Digitais
Tools = Ferramentas
Arc Center = Centro do Arco
Arc Type =
Center Point Arc =
Two-point Arc =

Place = Colocar
Drawing Tools = Ferramentas de Desenho
Arc = Arco
Elliptical Arc = Arco Elíptico
Ellipse = Elipse
Circle = Círculo
Pie = Torta
Line = Linha
Polyline =
Rectangle = Retângulo
Rectangular = Retangular
The rectangle does not support non-90 degree rotation. Please use Solid Region instead. =

Rect = Retificar
Round Rectangle = Retângulo Arredondado
Polygon = Polígono
Bezier = Bézier
Path = Caminho
Graphic = Gráfico
Bus = Barramento
Bus Entry = Entrada de Barramento
Junction = Junção
Net Port = Porta-Net
Voltage Probe = Sonda de Tensão
Power Port = Porta-Alimentação
Wire = Fio
Annotation = Anotação
Track = Faixas
Image = Imagem
Arrow Head = Cabeça de Seta
Arrowhead = Ponta de Seta
Arrow = Seta
No Connect Flag = Bandeira-Não Conetado
Place = Colocar
Pin = Pino
Lock Selected Objects = Bloquear Objetos Selecionados

Miscellaneous = Diversos
Find Component = Encontrar Componente
Component = Componente
Footprint... = Footprint...
This component is deleted! = Este componente está deletado!
Convert = Converter
Convert Schematic to PCB = Converter esquema para PCB
The component ID will be reset according to the component prefix, this operation will clear Undo histories. Please notice: = A ID do componente será redefinida de acordo com o seu prefixo. Essa operação limpará o histórico de "Desfazer". Por favor preste atenção:
Please make sure the component prefixes of the schematic and PCB are corresponding = Tenha certeza de que os prefixos do componente no esquema e na PCB correspondem.
Please reset the component ID of corresponding schematic or corresponding PCB too = Redefina a ID do componente no esquema ou PCB correspondentes também.
Do you want to continue? = Deseja Continuar?
Reset Component ID = Redefinir ID do Componente
Component ID reset successfully! = Redefinição de ID do Componente bem-sucedida!
Convert to PCB = Converter para PCB
Update PCB = Atualizar PCB
Shortcut Keys Setting = Configuração de Teclas de Atalho
Edit Symbol... = Editar Símbolo…
Highlight Net... = Realce Net…
Simulate = Simular
Simulation = Simulação
Standard Mode = Modo padrão
Simulation Mode = Modo de simulação
Change to Standard Mode = Mudar para o modo padrão
Change to Simulation Mode = Mudar para o modo de simulação
Welcome to Use LCEDA = Bem-Vindo ao LCEDA
Welcome to Use EasyEDA = Bem-Vindo ao EasyEDA
Enable Education Edition Features for Free >>> = Ativar Recursos da Edição de Educação de Graça >>>
Quick Start = Início Rápido
More Help = Mais Ajuda
Explore = Explorar
Message = Mensagens
[start]
Example = Exemplo
Forum = Fórum
Tutorials = Tutoriais
Videos = Vídeos
[/start]
Custom Data =
LCEDA =

Copy Result Image = Copiar Imagem Resultante
Export Result Image = Exportar Imagem Resultante
Simulation Result = Resultado da Simulação
Simulation Results... = Resultados da Simulação…
Simulate this Sheet = Simular esta Folha
Simulate this Project = Simular este Projeto
Non-simulation mode, please switch to the simulation mode first and then run =
Run the Document = Executar este Documento
Run the Project... = Executar este Projeto…
Netlist for Document = Netlist para o Documento
Netlist for Project = Netlist para o Projeto
LTspice for This Sheet... = LTspice para essa Folha
Spice for this Project... = Spice para este Projeto…
Protel/Altium for PCB... = Protel/Altium para PCB…
PADS for PCB... = PADS para PCB...
FreePCB for PCB... = FreePCB para PCB…
Eagle for PCB... = Eagle para PCB…
Kicad for PCB... = Kicad para PCB…
OrCAD for PCB... = OrCAD Para PCB…
BOM report... = Relatório de Lista Técnica…
BOM for Document... = BOM para Documento…
BOM for Project... = BOM para Projeto…
Pin Manager... = Gerenciador de Pins
Spice Model... = Modelo Spice...
Layer Manager... = Gerenciador de Camadas
Net Color... = Cor da Rede...
Design Rule... = Regras de Design
Copper Area = Área de Cobre
Rebuild Selected = Reconstruir Seleção
Rebuild All = Reconstruir todos
Copper Area Manager... = Gerenciamento da Área de Cobre…
Export Pick and Place File = Exportar Arquivo de Pick and Place
Measure Distance = Medir Distância
Set Canvas Origin by Mouse Location = Colocar Origem da Tela pela Localização do Mouse
Generates Pick and Place File = Gerar Arquivo Pick and Place
Unroute All = Remover todas as Trilhas
Auto Route = Roteamento Automático
Export Autorouter File(DSN) = Exportar Arquivo de Autorota(DSN)
Import Autorouter Session File(SES) = Importar Sessão de Autorota(SES)
Autorouter File(DSN) = Arquivo de Autorota(DSN)
Autorouter Session File(SES) = Arquivo de Sessão de Autorota(SES)
Terminate Routing Automatically = Terminar Roteamento Automaticamente
Delete Segments = Deletar Segmentos
Unroute Connections = Desfazer Trilha de Conexões
Unroute Connection = Desfazer Trilha de Conexão
Unroute Nets = Desfazer Trilha de Redes
Select = Selecionar
Segments = Segmentos
Connection = Conexão
Net = Rede
Apply Design Rule While Routing and Auto Placing Via = Aplicar Regra de Design Enquanto faz a Trilha e Coloca Vias Automaticamente

Add SubPart = Adicionar SubParte
Annotate... = Anotar…
Config = Configurar

Help = Ajuda
About = Sobre
Shortcut Keys = Teclas de Atalho
FAQ = FAQ
Tutorials = Tutoriais
Basic Tutorials = Tutoriais Básicos
Video Tutorials = Vídeo Tutoriais
Essential Check = Verificação Essencial
Simulation Tutorials = Tutoriais de Simulação
Updated Instructions = Instruções Atualizadas
Open File Format = Abrir Formato de Arquivo
About Upgrade = Sobre Atualização
User Forum = Fórum de Usuário
Feature Request = Solicitação de Recurso
Feature Requests = Solicitações de Recurso
Bug Report = Relatório de Bug
Bug Reports = Relatóris de Bugs
Tips & Skill = Dicas e Habilidades
Ask for Help = Peça Ajuda
Schematic Capture = Captura esquemática
Spice Simulation = Simulação Spice
Non-simulation mode = Modo de Não-Simulação
PCB Layout = Layout do PCB
General Discussion = Discussão Geral
More Information = Mais Informações
Privacy Policy = Política e Privacidade
#Terms of Use & Privacy Policy
Terms of Service = Termos do Serviço
Plans and Pricing = Planos e Preços
Help Translate = Ajudar a Traduzir
About Us = Sobre nós
Contact Us = Contate-nos
Change History = Histórico de Mudanças
Join Us = Junte-se a nós
#PCB Fabrication Capabilities
PCB Fabrication = Fabricação de PCB
Order Capabilities = Capacidade de Pedidos
Order Price = Preço do Pedido
Order Essential Check = Checar Pedido Essencial
Order FAQ = FAQ Pedido
Order Process = Processo do Pedido
Full Screen = Tela Cheia

Support = Suporte
[leftNavTabs]
Support = Suporte
[/leftNavTabs]
Historical Records... = Registros Históricos…
Extensions = Extensões
Order PCB... = Encomendar PCB…
Import Changes = Importar alterações
Press {0}F11{1} to switch to full screen. = Pressione {0} F11 {1} para mudar para tela cheia.
Delete Selected = Excluir selecionado
Simulate... = Simular…
Config = Configurar
Terms of Service & Privacy Policy = Termos de Serviço e Política de Privacidade
Help Topics = Tópicos da Ajuda
3D Model(obj) = Modelo 3D(obj)
3D Model(step) = Modelo 3D(passo)
SVG Source... = Fonte SVG…
File Source = Origem do Arquivo
Group These Items as a Symbol = Agrupar Esses Itens como um Símbolo
Group These Items as a Footprint = Agrupar Esses Itens como um Footprint
Set Canvas Origin = Definir Origem da Tela
Document Setting = Configuração do documento
Sheet Properties = Atributos da folha
Set Board Outline = Definir contorno da placa
Teardrop... = Teardrop…
Panelize... = Panelize…
Check Dimension = Verificar dimensão
Smart Dimension = Dimensão Inteligente
Footprint Wizard = Assistente de Footprint
Footprint Wizard... = Assistente de Footprint...
Select package type = Selecionar tipo de pacote
Smart Dimension Properties = Atributos da Dimensão Inteligente
Global Delete = Apagar global
Cross Probe = Cross Probe
Cross Probe and Place = Cross Probe and Place
Paper Size = Tamanho do papel
Register = Registrador
User Center = Centro de Usuários

By Mouse Location = Pela Localização do Mouse
Set Coordinate = Colocar Coordenadas
By Coordinates... = Por Coordenadas
By Center of Pads = Pelo Centro do Bloco
By Center Grid of Symbols = Pelo Centro da Grade de Símbolos

#Schematic Canvas Properties
Properties = Propriedades
Apply = Aplicar
Save as default = Salvar como padrão
Canvas Properties = Atributos do Canvas
Width = Largura
Height = Altura
Background = Fundo
Visible Grid = Grade Visível
Grid Visible = Grade Visível
Real-Time Track Length = Monitorar Comprimento em Tempo Real
Display Real-Time Track Length = Exibir Monitoramento de Comprimento em Tempo Real
Grid Color = Cor da Grade
Grid Size = Tamanho da grade
Grid Style = Estilo da grade
Grid.Line Width = Grade.Linha Largura
Grid.Line Spacing = Grade.Linha Espaçamento
Copper to Board Outline = Cobre para Contorno da Placa
Improve Fabrication = Melhorar Fabricação
Spoke Width =
Stroke Color = Cor do traço
Stroke Width = Largura do traçado
Stroke Style = Estilo do traçado
Fill Color = Cor de preenchimento
Selected Objects = Objetos Selecionados
Frame Size = Tamanho do quadro
Alt Snap = Alt Snap
Snap size when pressing the Alt key = Grudar o tamanho quando pressionar a tecla Alt
Prefix Start = Prefixo de Início

#Text Properties
Text Properties = Atributos de texto
Text = Texto
Color = Cor
Font Family = Família de Fontes
Font Size = Tamanho da Fonte
Font Weight = Peso da Fonte
Font Style = Estilo da Fonte
Text Type = Tipo de Texto
Text Anchor = Âncora de texto
Baseline = Linha de base
(Auto) = (Auto)
(auto) = (auto)
start = início
middle = meio
end = fim
inherit = herdar
comment = comentário
spice = spice
normal = normal
italic = itálico
Default = Padrão
Add = Add
bold = negrito
bolder = mais negrito
lighter = mais claro
Failed to parse the font file: {name} = Falha ao analisar o arquivo de fonte: {name}
Please select a font file of ttf or woff format. = Por favor, selecione um arquivo de fonte do formato ttf ou woff.
Add font success: {name} = Adicione o sucesso da fonte: {name}
Failed to add font: {name} = Falha ao adicionar fonte: {name}
Add Font = Adicionar Fonte
Failed to parse cached font: {name} = Falha ao analisar a fonte em cache: {name}
Load cached fonts fail! = Falha ao carregar fontes armazenadas em cache!

#Stroke
Stroke Color = Cor do traço
Stroke Width = Largura do traçado
Stroke Style = Estilo do traçado
Fill Color = Cor de preenchimento
X Radius = Raio X
Y Radius = Raio Y

#spice
Switch mode = Trocar modo
The current documents will be closed, and reopen after switching mode, do you want to continue? = Os Documentos em aberto serão fechados e, após a troca de modo, serão reabertos. Deseja continuar?
PCB related documents are not allowed in emulation mode = Documentos relacionados à PCB não são permitidos no modo de emulação
Please change the editor to "Simulation" mode first at the top left corner. = Por favor primeiro mude o editor para o modo "Simulação" no topo esquerdo superior
Please change the editor to "Standard" mode first at the top left corner. = Por favor primeiro mude o editor para o modo "Padrão" no topo esquerdo superior
Common = Comum
spice.open = spice.abrir
spice.close = spice.fechar
Sources = Recursos
Instruments/Meters = Instrumentos / Medidores
Transistors = Transistores
Digital Circuits = Circuitos Digitais
Operational Amplifier = Amplificador Operacional
multimeter = multímetro
multimeter Settings = Configurações de multímetro
FunctionGenerator Settings = Configurações do Gerador de Funções
Voltage Source Settings = Configurações da Fonte de Tensão
Current Source Settings = Configurações da Fonte de Corrente
Powersw Settings = Configurações Powersw
Resistor Settings = Configurações do Resistor
Capacitor Settings = Configurações do Capacitor
Diode Settings = Configurações do Diodo
voltPowersw Settings = Configurações da voltPowersw
Inductor Settings = Configurações do Indutor
VCVS Settings = Configurações VCVS
CCCS Settings = Configurações CCCS
VCCS Settings = Configurações VCCS
CCVS Settings = Configurações CCVS
JFET Settings = Configurações JFET
FET Settings = Configurações FET
Transmission Line Settings = Configurações da Linha de Transmissão
Oscilloscope Settings = Configurações do Osciloscópio
XFMR Settings = Configurações XFMR
LOGIC Settings = Configurações LOGIC
LOGICSTATE Settings = Configurações LOGICSTATE
DIGITALCLOCK Settings = Configurações DIGITALCLOCK
Potentiometer Settings = Configurações do Potenciômetro
MUTUAL_INDUCTORS Settings = Configurações MUTUAL_INDUCTORS
NE555 Settings = Configurações NE555
THREE_PHASE Settings = Configurações THREE_PHASE
Logic_Probe Settings = Configurações Logic_Probe
78XX Settings = Configurações 78XX
79XX Settings = Configurações 79XX
OPAMP5PEE Settings = Configurações OPAMP5PEE
OPAMP5PEECN Settings = Configurações OPAMP5PEECN
OPAMP3PEE Settings = Configurações OPAMP3PEE
OPAMP3PEECN Settings = Configurações OPAMP3PEECN
DELAY_FUSE Settings = Configurações DELAY_FUSE
Ratio = Razão
K[%] = K[%]
Model = Modelo
States = Estados
Voltage[V] = Tensão[V]
Voltage gain[V/V] = Ganho de Tensão[V/V]
Current gain[A/A] = Ganho de Corrente[A/A]
Transconductance[Mho] = Transcondutância[Mho]
Transresistance[Ω] = Transresistência[Ω]
Voltage Source Type = Tipo de Fonte de Tensão
Current Source Type = Tipo de Fonte de Corrente
multimeter type = tipo de multímetro
power type = tipo de força
Voltmeter Resistance(R)(Ω) = Resistência do Voltímetro(R)(Ω)
Amperometer Resistance(R)(Ω) = Resistência do Amperímetro(R)(Ω)
mu.V = mu.V
mu.A = mu.A
Sine Wave = Onda Senoidal
Triangular Wave = Onda Triangular
Rectangular Wave = Onda Retangular
AC = AC
DC = DC
SINE = SENO
PULSE = PULSO
EXP = EXP
SFFM = SFFM
PWL = PWL
B.spice = B.spice
DC Value[V] = Valor CC[V]
DC Value[A] = Valor CC[A]
DC offset[V] = Deslocamento CC[V]
DC offset[A] = Deslocamento CC[A]
Amplitude[V] = Amplitude[V]
Amplitude[A] = Amplitude[A]
Freq[Hz] = Freq[Hz]
Theta[1/s] = Theta[1/s]
Tdelay[s] = Tatraso[s]
Phi[deg] = Phi[graus]
Tperiod[s] = Tperíodo[s]
Ton[s] = Tligado[s]
Tfall[s] = Tdescida[s]
Trise[s] = Tsubida[s]
Von[V] = Vligado[V]
Von[A] = Vligado[A]
Vinitial[V] = Vinicial[V]
Vinitial[A] = Vinicial[A]
Vpulsed[V] = Vpulsado[V]
Vpulsed[A] = Vpulsado[A]
Rise Delay[s] = Atraso de Subida[s]
Rise Tau[s] = Tau de Subida[s]
Fall Delay[s] = Atraso de Descida[s]
Fall Tau[s] = Tau de Descida[s]
Carrier Freq[Hz] = Freq Portadora[Hz]
Modulation Index = Índice de Modulação
Signal Freq[Hz] = Freq do Sinal[Hz]
Time[s] = Tempo[s]
Value[V] = Valor[V]
Value[A] = Valor[A]
Waveforms = Forma de Onda
Duty cycle[%] = Ciclo de Trabalho[%]
Amplitude[Vp] = Amplitude[Vp]
Offset[V] = Deslocamento[V]
Rise/Fall Time[sec] = Tempo de Subida/Descida[seg]
Capacitance[F] = Capacitância[F]
sComponent = sComponente
Inductance[H] = Indutância[H]
Gbw = Gbw
Slewrate = Slewrate
Avol = Avol
Rout(Ω) = Rout(Ω)
Rin(Ω) = Rin(Ω)
Ibias[A] = Ipolarização[A]
Inhi[V] =
Inlo[V] =
Isc[A] =
Outhi[V] =
Outlo[V] =
Vabsmax[V] =
Vmin[V] =
Iq[A] =
Cin[F] =
high = alto
low = baixo
Oscilloscope = Osciloscópio
Logic Analyzer = Analisador Lógico
Channel_A = Canal_A
Channel_B = Canal_B
Channel A = Canal A
Channel B = Canal B
Time = Tempo
Reverse = Reverso
Simulation file exceed = Arquivo de Simulação Excedido
The simulation file is too large and has been stopped for performance reasons. = O arquivo de simulaçào é muito grande e foi parado por motivos de performance
Timebase = Base de Tempo
Scale: = Escala:
X pos.(Div): = X pos.(Div)
Y pos.(Div): = Y pos.(Div)
View meter... = Ver medidor...
The circuit has components without simulation model: = O circuito tem componentes sem modelo de simulação
Your simulation interval is too short to simulate, please wait 5 seconds later and try again; if still show this message, may be you simulated over 500 times the maximum simulation times per day. = O intervalo da sua simulação é muito curto, espere 5 segundos e tente novamente; se esta mensagem persistir, talvez você tenha simulado mais de 500 vezes, que é o limite diáro.
Resistor1_US = Resistor1_US
Resistor1_EU/IEC = Resistor1_EU/IEC
Resistor1_3D = Resistor1_3D
Capacitor1_US = Capacitor1_US
Capacitor1_EU/IEC = Capacitor1_EU/IEC
Capacitor1_3D = Capacitor1_3D
Rheostat_US = Reostato_US
Rheostat_EU/IEC = Reostato_EU/IEC
Rheostat_3D = Reostato_3D
Capacitor_Electrolytic_US = Capacitor_Electrolítico_US
Capacitor_Electrolytic_EU/IEC = Capacitor_Electrolítico_EU/IEC
Capacitor_Electrolytic_3D = Capacitor_Electrolítico_3D
Inductor_US = Indutor_US
Inductor_EU/IEC = Indutor_EU/IEC
Inductor_3D = Indutor_3D
Resistor2_US = Resistor2_US
Resistor2_EU/IEC = Resistor2_EU/IEC
Resistor2_3D = Resistor2_3D
Multimeter = Multímetro
Multimeter_3D = Multímetro_3D
Oscilloscope = Osciloscópio
Oscilloscope_3D = Osciloscópio_3D
Signal_Generator = Gerador_de_Sinais
Signal Generator_3D = Gerador de Sinais_3D
Wattmeter = Wattímetro
Wattmeter_3D = Wattímetro_3D
NSSWS1080T_3D = NSSWS1080T_3D
Voltage_Source_VDC = Fonte_Tensão_VCC
Voltage_Source_VSin = Fonte_Tensão_VSen
Voltage_Source_VPULSE = Fonte_Tensão_VPULSO
Voltage_Source_VEXP = Fonte_Tensão_VEXP
Voltage_Source_VSFFM = Fonte_Tensão_VSFFM
Voltage_Source_VPWL = Fonte_Tensão_VPWL
Voltage_Source_V_Behavioral_Source = Fonte_Tensão_V_Comportamental
Current_Source_IDC = Fonte_Corrente_ICC
Current_Source_ISin = Fonte_Corrente_ISen
Current_Source_IPULSE = Fonte_Corrente_IPULSO
Current_Source_IEXP = Fonte_Corrente_IEXP
Current_Source_ISFFM = Fonte_Corrente_ISFFM
Current_Source_IPWL = Fonte_Corrente_IPWL
Current_Source_I_Behavioral_Source = Fonte_Corrente_I_Comportamental
CCCS_1 =
CCCS_2 =
CCVS_1 =
CCVS_2 =
VCCS =
VCVS =
Three_Phase_Wye_Load = Carga_Trifásica_em_Y
Three_Phase_Delta_Load = Carga_Trifásica_em_Delta
78XX = 78XX
79XX = 79XX
555 = 555
555_3D = 555_3D
Transformer_US = Transformador_US
Transformer_EU/IEC = Transformador_EU/IEC
Transformer_Center_Tapped_US = Transformador_Tap_Central_US
Transformer_Center_Tapped_EU/IEC = Transformador_Tap_Central_EU/IEC
Mutual_Inductor_US = Indutor_Mútuo_US
Mutual_Inductor_EU/IEC = Indutor_Mútuo_EU/IEC
Mutual_Inductor2_US = Indutor_Mútuo2_US
Mutual_Inductor2_EU/IEC = Indutor_Mútuo2_EU/IEC
OR2EE_US = OR2EE_US
OR3EE_US = OR3EE_US
OR4EE_US = OR4EE_US
OR2EE_CN = OR2EE_CN
OR3EE_CN = OR3EE_CN
OR4EE_CN = OR4EE_CN
NOR2EE_US = NOR2EE_US
NOR3EE_US = NOR3EE_US
NOR4EE_US = NOR4EE_US
NOR2EE_CN = NOR2EE_CN
NOR3EE_CN = NOR3EE_CN
NOR4EE_CN = NOR4EE_CN
AND2EE_US = AND2EE_US
AND3EE_US = AND3EE_US
AND4EE_US = AND4EE_US
AND2EE_CN = AND2EE_CN
AND3EE_CN = AND3EE_CN
AND4EE_CN = AND4EE_CN
NAND2EE_US = NAND2EE_US
NAND3EE_US = NAND3EE_US
NAND4EE_US = NAND4EE_US
NAND2EE_CN = NAND2EE_CN
NAND3EE_CN = NAND3EE_CN
NAND4EE_CN = NAND4EE_CN
XOR2EE_US = XOR2EE_US
XOR2EE_CN = XOR2EE_CN
XNOR2EE_US = XNOR2EE_US
XNOR2EE_CN = XNOR2EE_CN
Digital_Clock_1Hz = Relógio_Digital_1Hz
Logicstate_0 = EstadoLógico_0
Logicstate_1 = EstadoLógico_1
Logic_Probe = Sonda_Lógica
Buffee =
INVEE_US =
INVEE_CN =
Schmittbuffee =
LM358N_US = LM358N_US
LM358N_CN = LM358N_CN
OPAMP3PEE_US = OPAMP3PEE_US
OPAMP3PEE_CN = OPAMP3PEE_CN
OPAMP5PEE_US = OPAMP5PEE_US
OPAMP5PEE_CN = OPAMP5PEE_CN
Voltage_Controlled_Switch = Chave_Controlada_por_Tensão
Current_Controlled_Switch = Chave_Controlada_por_Corrente
FUSE = Fusível
Delay_Fuse = Atraso_Fusível
Transmission_Line = Linha_de_Transmissão
Crystal = Cristal
DFFEE = DFFEE
TFFEE = TFFEE
JKFFEE = JKFFEE
SRFFEE = SRFFEE
SRLATCHEE = SRLATCHEE
SRNANDFFEE = SRNANDFFEE
SRNORFFEE = SRNORFFEE
INVTSEE =
INVODEE =
Schmittbuffee =
Cbuffer =
SPDT_Open = SPDT_Aberta
SPDT_Close = SPDT_Fechada
SPST_Close = SPST_Aberta
SPST_Open = SPST_Fechada
Fast_Crystal = Cristal_Rápido
Lamp = Lâmpada
BCD_Segment = Display_BCD_Sete_Segmentos
Seven_Segment = Display_Sete_Segmentos
Traffic_Light = Semáforo
Lamp Settings = Parâmetros da Lâmpada
Power[W] = Potência[W]
Dropout Voltage[V] = Tensão de Dropout[V]
Current[A] = Corrente[A]
Threshold[V] = Limiar[V]
Clock Rate = Taxa de Clock
TrafficLight Settings = Parâmetros do Semáforo
BCDSegment Settings = Parâmetros do Display BCD
SevenSegment Settings = Parâmetros do Display de Sete Segementos
SPDT Settings = Configurações SPDT
SPST Settings = Configurações SPST
LogicAnalyzer Settings = Configurações do Analisador Lógico
Fuse Settings = Configurações de Fusível
Wattmeter Settings = Configurações do Wattímetro
open = abrir
close = fechar
Common Anode = Ânodo Comum
Common Cathode = Cátodo Comum
AC Amplitude = Amplitude AC
AC Phase = Fase AC
There are some parts haven't spice model, please use "EElib" and "Spice Symbol" at "Libraries" of "Simulation" mode, or you can assign the spice model for them: = Algumas peças não têm modelo spice, por favor use "EElib" e "Spice Symbol" em "Bibliotecas" do modo "Simulação", ou você pode designar um modelo spice para eles:

#Pin
Pin Properties = Atributos do Pin
Orientation = Orientação
Line 45° = Linha 45°
Line 90° = Linha 90°
Arc 45° = Arco 45°
Arc 90° = Arco 90°
Free Angle = Ângulo Livre
Start X = Início X
Start Y = Início Y
Length = Comprimento
Name = Nome
name = nome
Number = Número
Spice Pin Order = Pedido Spice Pin
Display Number = Número de Exibição
Clock = Tempo
Show = Mostrar
Electric = Elétrico

#Junction
Junction Properties = Atributos de junção
X Location = localização X
Y Location = localização Y
Size = Tamanho
Color = Cor

#Net Label
Net Label = Rótulo de Rede

#Part
Prefix = Prefixo

#Image Properties and Dialog
Add Image = Adicionar imagem
Image Properties = Atributos de Imagem
Image URL = URL da imagem
Input an image URL = Insira uma URL de imagem
Invalid image URL = URL de imagem inválido
Invalid Prefix = Prefixo Inválido
Failed to load the image = Falha ao carregar a imagem
Image URL contains special characters = URL da imagem contém caracteres especiais
From Web URL = De URL da Web
From Local Computer = De computador local
Please select a png/gif/jpg file. = Por favor, selecione um arquivo png / gif / jpg.
Please select an image file. = Por favor, selecione um arquivo de imagem.
Select an image file = Selecione um arquivo de imagem
Insert Image to PCB = Inserir imagem para PCB
Tolerance = Tolerância
tolerance = tolerância
capacitance = capacitância
frequency = frequência
Rated Voltage = Tensão Nominal
Rated Current = Corrente Nominal
resistance = resistência
Resistance = Resistência
Resistance[Ω] = Resistência[Ω]
inductance = indutância
Operating Temperature = Temperatura de operação
Shape Invert = Forma Invertida
Image Size = Tamanho da imagem
Color Tolerance = Tolerância de Cor
Simplify Level = Simplificar Nível
Corner Threshold = Limiar da Borda

#PCB Canvas Properties
Units = Unidades
Snap Size = Tamanho Snap
Other = Outro
Routing Width = Largura de Roteamento
[router]
Routing Width = Largura de Roteamento
[/router]
Please using hotkey {0}{shiftw}{1} or {2}{tab}{3} to change track width while on routing. =
Routing Angle = Ângulo de roteamento
Routing Conflict = Conflito de roteamento
Remove Loop = Remover Loop
Cut SilkScreen =
Grid = Grade
Grid 90 = Grade 90
Grid 45 = Grade 45
Copper Zone = Zona de Cobre
Visible = Visível
Invisible = Invisível
Ignore = Ignore
Block = Bloquear
RoundTrack =

#Track
Track Properties = Propriedades da trilha
Layer = Camada
Net = Net
Start X = Início X
Start Y = Início Y
End X = Fim X
End Y = Fim Y
ID = ID

#Pad Properties
Pad Properties = Propriedades de Pads
Shape = Forma
Hole(D) = Buraco (D)
Center X = Centro X
Center Y = Centro Y
Round = Redondo
Oval = Oval
Hole Shape = Forma do Furo
Slot = Slot
Hole(Length) = Furo(Comprimento)
Plated = Banhado
None = Nenhum
Paste Mask Expansion = Expansão de Mascára de Pasta
Solder Mask Expansion = Expansão de Mascára de Solda

#Via Properties
Via Properties = Propriedades da Via
Diameter = Diâmetro
Drill Diameter = Diâmetro de Perfuração

#Hole Properties
Hole Properties = Propriedades do furo


#TEXT
Text Properties = Propriedades de texto
Line Width = Largura da linha
Rotation = Rotação
Fonts Management = Gerenciamento de fontes

#Dimension Properties
Dimension Properties = Atributos de dimensão

#Footprint Properties
Component Properties = Características do Componente
Display Prefix = Mostrar Prefixo
Pin Name = Nome do Pino
Pin Number = Número do Pino
Spice Pin Number = Número do Spice Pin
Graphics = Gráficos
Pattern = Padrão

#Arc Properties
Arc Properties = Propriedades do Arco
Start Angle = Início do Ânhulo
End Angle = Final do Ângulo
Rotation Direction = Direção de Rotação

#Rect Properties
Rect Properties = Propriedades de retoque
Round radius = Raio Redondo

#Circle Properties
Circle Properties = Propriedades do Círculo
Radius = Raio

#CopperArea Properties
CopperArea Properties = Propriedades de CopperArea
Clearance = Afastamento
Pad Connection = Conexão do Pad
Direct = Direto
Spoke = Spoke
Keep Island = Mantenha a ilha
Fill Style = Completar Estilo
CopperArea conflict: copper area outlines in same layer with different net names must not overlap = Conflito CopperArea: os contornos da área de cobre na mesma camada com nomes de rede diferentes não devem se sobrepor
Copper area rebuild complete! You can set "Copper Zone" as "Visible" at the right-hand property panel after single click the empty area. =
Please create board outline first. = Por favor, crie primeiro o contorno da placa.
Board outlines are not closed. = Contornos da placa não estão fechados.
Rebuild CopperArea = Reconstruir CopperArea
Edit Points = Editar pontos
Direct = Direto
Spoke = Spoke
No Solid =
Board Cutout =
Solid = Sólido
[copperArea]
None = Nenhum
[/copperArea]

#Custom Properties
Custom Properties = Atributos personalizados
Fixed Properties = Atributos Fixados
Add new parameter = Adicionar novo parâmetro
Add New Parameter = Adicionar Novo parâmetro
Add New Supplier = Adicionar Novo Fornecedor
Mounted = Montado
Unknown = Desconhecido

Custom = Personalizado
Scan the QR code below and open it on the mobile side = Escaneie o code QR abaixo e abra-o no mobile
How to create a single layer PCB = Como criar uma PCB de uma camada
Currently doesn't support layout single layer directly, please refer at: = Atualmente não suporta layout de uma camada diretamente, por favor veja:

#Dialog Register
Create an account = Crie uma conta
Username = Nome de usuário
Password = Senha
Confirm Password = Confirme a Senha
Email = Email
Please read this before you register = Por favor, leia isto antes de se registrar
Hi {username} = Olá {username}

#Dialog lostPassword
Lost Password... = Esqueci a Senha…
Find the password using your email = Encontre a senha usando seu email



#Dialog Login
Login = Login
Username or Email = Nome do Usuário ou Email
Remember Me = Lembrar da Conta
Third party = Terceiros
Login and Register = Login e Registro
Your login information seems expired, please login again. Don't need to close the opening files, you can continue to save them after login. =

#Dialog Reset Password
Reset a password using your email = Redefinir uma senha usando seu Email
Your registered email = Seu E-mail cadastrado

#Dialog Reaction
Re-send an activation code to your email = Reenvie um código de ativação para o seu email

#Dialog Invite
Invite friends to register = Convide amigos para se cadastrarem
Your friend's email = E-mail do seu amigo

#Dialog Add A New Parameter
Add a new parameter = Adicione um novo parâmetro
Key = Chave
Value.new_para = Value.new_para
In BOM = Na lista de materiais (BOM)
Add into BOM = Adicionar à BOM
Invalid key = Chave inválida
This field is required. = Este campo é obrigatório.

#Dialog Change Your Password
Change your password = Mude sua senha
Old password = Senha antiga
New Password = Nova senha
Confirm Password = Confirme a Senha

#Dialog Create New Design
Save as a New Project = Salvar como um novo projeto
Save as a schematic = Salvar como um esquema
Save as Symbol = Salvar como Símbolo
Save as a spice Symbol = Salvar como um símbolo Spice
Save as a spice subckt = Salvar como um subckt Spice
YOU MUST CREATE A SPICE SYMBOL WITH EXACTLY THE SAME NAME AS THIS SUBCKT = VOCÊ DEVE CRIAR UM SÍMBOLO SPICE EXATAMENTE O MESMO NOME DESTE SUBCKT
Save as a PCB file = Salvar como um arquivo PCB
Save as Footprint = Salvar como um Footprint
Save as a Schematic Module = Salvar como um módulo esquemático
Save as a PCB Module = Salvar como um módulo PCB
Save as 3D Model = Salvar como modelo 3D
Save as a WaveForm = Salvar como Forma de Onda
Title = Título
Share = Compartilhar
Add file = Adicionar arquivo
Visibility = Visibilidade
Allow Comments = Permitir comentários
Public (Anyone can see this project but only you can modify it.) = Público (qualquer um pode ver este projeto, mas somente você pode modificá-lo)
Private (Only you can see and modify this project) = Particular (somente você pode ver e modificar este projeto)
Create new project success! = Criado novo projeto com sucesso!
You can now create files under this project = Agora você pode criar arquivos sob este projeto
This file must be saved under a project, choose other project or create a new project = Esse arquivo precisa ser salvo dentro de um projeto, escolha um projeto ou crie um novo projeto
Please login to save this kind of document = Por favor faça login para salvar esse tipo de documento
Duplicated project title = Título de projeto duplicado
#Duplicated document title
Project does not exist = Projeto não existe
Document does not exist = Documento não existe
document not exists = documento não existe

Categories = Categorias
Project = Projeto
Short description = Pequena descrição
Content = Conteúdo
Modify this project info. = Modifique esta informação do projeto.
Modify this file info. = Modifique esta informação de arquivo.
Notice = Aviso
Search for it before creating a new one. = Pesquise antes de criar um novo.
Manufacturer Part Number = Número da Peça do fabricante
Supplier = Fornecedor
Or = Ou
Supplier Part = Peça do Fornecedor
Supplier Part Number = Número da Peça do fornecedor
Link = Link
link = link
The professional function please refer at: = A função profissional, por favor consulte:

#Dialog Clone My Part
#Clone it to a project
#Clone it, then edit it
Clone your file = Clone seu arquivo

#Dialog Subckt
Attach a Subckt to this spice symbol = Anexe um Subckt a este símbolo Spice
Subckt string = Cadeia Subckt
Spice symbol title just allow [0-9][a-z][A-Z] and _

#Design Manager
Design Manager = Gerente de Design
Nets = Redes
DRC Errors = Erros DRC
Are you sure you want to unroute this net? = Tem certeza de que deseja desviar esta rede?
Unroute = Unroute
Track Length = Comprimento da faixa
Via/Hole Outer Size = Via / Hole Outer Size
Filter nets = Redes de filtro
Design Rule Checking = Checagem de Regras de Design
Board Outline = Contorno da Placa
Plane Zone =
[drcRule]
Width = Largura
DRC Width = Largura DRC
Length = Comprimento
DRC Length = Comprimento DRC
Drill Diameter = Diâmetro de Perfuração
DRC Drill Diameter = Diâmetro Drill DRC
Diameter = Diâmetro
DRC Diameter = Diâmetro DRC
Object = Objeto
DRC Clearance = Autorização DRC
[/drcRule]
#It will take a while to unroute this net, do you want to continue?
More than one netlabel is found in wire, please checked whether this is correct, if you design it on purpose, please ignore this warning. = Mais de um rótulo de rede encontrado no fio, por favor verifique se isto está correto. Caso tenha projetado assim de propósito, ignore este aviso.
Incomplete net, a complete net should contain two or more pins, if you design it on purpose, please ignore this warning. = Rede incompleta. Uma rede completa deve conter dois ou mais pinos. Se você projetou assim de propósito, ignore este aviso.
This netlabel is not connected with any pin. = Este rótulo de rede não está conectado a nenhum pino.
Incomplete connection, please check. = Conexão incompleta, por favor verifique.
The clearance between two objects is less than the Design Rule Checking (DRC) clearance which has different nets. = O afastamento entre os dois objetos é menor do que aquele definido pelas Regras de Verificação de Design (DRC) quando há redes diferentes.
The diameter is less than Design Rule Checking (DRC) diameter = O diâmetro é menor do que aquele definido pelas Regras de Verificação de Design (DRC)
The drill diameter is less than Design Rule Checking (DRC) drill diameter = O diâmetro do furo é menor do que aquele definido pelas Regras de Verificação de Design (DRC)
The track length is longer than Design Rule Checking (DRC) track length = O comprimento da trilha é maior do que aquele definido pelas Regras de Verificação de Design (DRC)
The track width is less than Design Rule Checking (DRC) track width = A largura da trilha é maior do que aquela definida pelas Regras de Verificação de Design (DRC)

#Dialog Simulation
Show your simulation report = Mostrar seu relatório de simulação
Download netlist = Baixar netlist
Run = Executar
Components = Componentes

#Dialog Import
Import file from your computer = Importar arquivo do seu computador
Maximum file size: 30 MB = Tamanho máximo do arquivo: 30 MB
Maximum file size: 100 MB = Tamanho máximo de arquivo: 100 MB
Chose file = Escolheu o arquivo
File Operation = Operação de Arquivo
Import File = Importar arquivo
Extract Libs = Extrair Libs
Import File and Extract Libs = Importar arquivo e extrair liberações
File type = Tipo de arquivo
The file size is too large. = O tamanho do arquivo é muito grande.
Please selected the file type. = Por favor, selecione o tipo de arquivo.
No component was found! = Nenhum componente foi encontrado!
Import successfully = Importar com sucesso
Import failed = Falha na importação
Click OK to continue with the import = Clique em OK para continuar com a importação
Select None = Selecione Nenhum

#Dialog Modify Symbol Information
Modify symbol information = Modificar informação do símbolo
Spice Prefix = Prefácio Spice
Hide Pin = Esconder Pin
Pin Manager = Gerenciador de Pin
When a power pin is hidden, it will be marked as netlabel, you don't need to wire it. If you use it as simulation, please show it or create a GND/VCC Net for it. = Quando um pino de energia está oculto, ele será marcado como netlabel, você não precisa conectá-lo. Se você usá-lo como simulação, por favor, mostre-o ou crie uma rede GND / VCC para ele.
Assign = Atribuir
Supplier.bom = Supplier.bom
LCSC.bom = LCSC.bom
Price = Preço
Quantity.bom = Quantity.bom
Package.bom = Package.bom
Components.bom = Components.bom
Manufacturer Part.bom = Fabricante Part.bom
Manufacturer.bom = Manufacturer.bom

One-click Purchasing at LCSC = Compre com um clique em LCSC
Order Parts = Encomendar Peças/Verificar Estoque
Export BOM = Exportar BOM
Export PCB BOM = Exportar BOM da PCB
Export Schematic BOM = Exportar BOM do Esquema
ID.bom = ID.bom
Name.bom = Name.bom
[bom]
Name = Nome
LCSC Assembly = Montagem da LCSC
Value = Valor
ID = ID
Supplier = Fornecedor
LCSC = LCSC
Price = Preço
Quantity = Quantidade
Package = Pacote
Components = Componentes
Manufacturer = Fabricante
[/bom]
Manufacturer Part = Peça do Fabricante

#Dialog Run
Run your simulation = Execute sua simulação
Transient = Transitório
Maximum Timestep = Timestep máximo
Stop Time = Hora de parada
Start Time = Hora de início

AC Analysis = Análise AC
Type of Sweep = Tipo de varredura
Number of points = Número de pontos
Start Frequency = Freqüência de Partida
Stop Frequency = Freqüência de Parada

DC sweep = Varredura DC
Source to Sweep = Fonte para varrer
Start Value = Valor inicial
Stop Value = Valor de Parada
Increment = Incremento
DC Transfer = Transferência CC
Output = Saída
Source = Fonte

DC op pnt = pnt opr CC
Compute the DC operating point treating capacitances as opens and inductances as shorts = Calcule as capacitâncias de tratamento do ponto de operação CC como abertas e indutâncias como fechadas

#Dialog Share Info
Active File = Arquivo Ativo
Active Project = Projeto ativo
Readonly = Somente Leitura
Editable = Editável
Active file's owner project page = Arquivo Ativo da Página do projeto do proprietário
Active project editor page = Projeto Ativo do Editor de Página

#Dialog Document Recovery
All Projects = Todos os projetos
Document Recovery = Recuperação de documentos
Unsaved files = Arquivos não salvos
Please select a file! = Por favor selecione um arquivo!
Please expand the folder first, then select a document to recover. = Por favor expanda a pasta primeiro, depois selecione um documento para recuperar.
Are you sure you want to remove this backup? = Tem certeza de que deseja remover este backup?

#Dialog Find Libs
Search = Pesquisa
Search Results = Resultados da pesquisa
Search and press Enter = Pesquisar e pressione Enter
Keywords at least 3 characters = Palavras-chave com ao menos 3 caracteres
Assembled = Montado
Verified = Verificado
In stock = Em estoque
{page} of {pagecount} pages = {page} de {pagecount} páginas
Common Modules = Módulos comuns
User Contributions = Contribuições de usuários
More = Mais
Add Favorite = Adicionar Favorito
Remove Favorite = Remover Favorito
Add Sub Part = Adicionar Sub Part
Untagged = Sem etiqueta
Package = Pacote
package = pacote
Title(PartNO) = Título (PartNO)
No Data! = Sem Dados!
Quantity = Quantidade
Manufacturer Part = Peça do Fabricante
manufacturer Part = peça do fabricante
Manufacturer = Fabricante
manufacturer = fabricante
voltage = tensão
Library = Biblioteca
LCSC Assembled = LCSC montado
JLCPCB Assembled = JLCPCB montado
User Contributed = Contribuído por Usuários
Symbol = Símbolo
Follow = Seguir
Types = Tipos
Classes = Classes
power = poder
Power = Poder
LCSC Part# = LCSC Part #
Stock = Estoque
Report Error... = Reportar erro...
Report Error = Reportar Erro
Thanks for your feedback! = Obrigado pelo seu feedback!
Report error success, thanks for your report! = Erro reportado com sucesso, obrigado por reportar!
The content must be at least 2 characters! = O conteúdo deve ter pelo menos 2 caracteres!
This library is user contributed, please check before using. = Esta biblioteca é proveniente de contribuições de usuários. Por favor verifique-a antes de usá-la.
[lib]
All = Tudo
System = Sistema
Personal = Pessoal
Created = Criado
Favorite = Favorito
No Team found. Please join or create a team first. = Nenhuma equipe encontrada. Por favor, junte-se ou crie uma equipe primeiro.
Create a team = Crie uma equipe
No follow user found. Please follow your friend first. = Nenhum usuário seguido por você encontrado. Por favor, siga seu amigo primeiro.
[/lib]


BUY = COMPRA
In Stock = Em estoque
Out of Stock = Fora de estoque
Minimum = Mínimo
Distributor = Distribuidor

Capacitance = Capacitância
Frequency Tolerance = Tolerância de Freqüência
Power (Watts) = Potência (Watts)
Power - Max = Potência - Máx
Frequency = Freqüência
Voltage Rating(Vdc,Vac) = Classificação de Voltagem (Vcc, Vac)
Voltage = Voltagem
Current Rating = Classificação de Corrente
Rated current = Corrente nominal
Resistance (Ohms) = Resistência (Ohms)
Resistance(Ohms) = Resistência(Ohms)
Inductance = Indutância
FET Type = Tipo FET
Current Rating(Max) = Classificação de Corrente (máx.)
Impedance @ Frequency = Impedância @ Frequência
Voltage - Input (Max) = Tensão - Entrada (Máx)
Voltage - Input (Min) = Tensão - Entrada (Mín)
Voltage - Supply = Tensão - Fornecimento
Voltage - Max = Tensão - Máx
Current - Output = Corrente - Saída

#Dialog Export Your Works
Export your works = Exportar seus trabalhos
Export to = Exportar para
Zoom = Zoom
Image Type = Tipo de imagem
Qualify = Qualificar
0 means real size = 0 significa tamanho real
Merged layer = Camada mesclada
Separated layer = Camada Separada
Paged layer =
Layer = Camada
Export = Exportar
Mirror = Espelho
TopLayer = TopLayer
BottomLayer = BottomLayer
TopSilkLayer = TopSilkLayer
Protractor Properties = Atributos do transferidor
BottomSilkLayer = BottomSilkLayer

BoardOutLine = ContornoDaPlaca
TopAssembly = TopAssembly
BottomAssembly = BottomAssembly
Mechanical = Mecânico
DocumentLayer = DocumentLayer
Inner{number} = Inner {number}
Substrate{number} = Substrato {number}
Color = Cor
Full Color = Cor completa
Canvas Setting = Definição de tela
Full Graphics = Gráficos Completos
Assembly Drawings = Desenhos de montagem
Object Outlines = Contorno dos Objetos
Invalid file format = Formato de arquivo inválido
Failed to export file = Falha ao exportar arquivo
Download now = Baixe agora
Wire Width = Largura do fio
Sheet = Folha
Merged sheet = Folha mesclada
Separated sheet = Folha separada
Engine =
Exporting PDF = Exportando PDF
Export 3D Model = Exportar modelo 3D
[exportDocument]
Size = Tamanho
[/exportDocument]

#Dialog Import Changes
Confirm Importing changes information = Confirme Importando informações de mudanças
You can't undo this operation, Please run a Design Rule Checking (DRC) after this operation. =
Apply Changes = Aplicar alterações
This is a simple Design Rule Checking (DRC). =
It just can help you to find the obvious errors = Ele só pode ajudá-lo a encontrar os erros óbvios
There are some unfinished nets, do you want to check the nets first? = Há algumas redes não finalizadas, deseja verificar as redes primeiro?
Yes, Check Nets = Sim, verifique redes
No, Keep Going = Não, continue

#Dialog Layer Manager
Configured = Configurado
Layer Name = Nome da camada
TopPasterLayer = TopPasterLayer
BottomPasterLayer = BottomPasterLayer
TopSolderLayer = TopSolderLayer
BottomSolderLayer = BottomSolderLayer
TopPasteMaskLayer = TopPasteMaskLayer
BottomPasteMaskLayer = BottomPasteMaskLayer
TopSolderMaskLayer = TopSolderMaskLayer
BottomSolderMaskLayer = BottomSolderMaskLayer
ComponentShapeLayer =
LeadShapeLayer =
ComponentMarkingLayer =
Ratlines = Ratlines
Ratlines Color = Cor das Ratlines
Manage Colors = Geranciar Cores
BoardOutline = ContornoDaPlaca
Multi-Layer = Camada Múltipla
Hole = Buraco
DRCError = DRCError
Setting = Configuração
Drawing area = Área de desenho
Export area = Área de exportação
Transparency(%) = Transparência(%)
Copper Layer = Camada de Cobre
Signal = Sinal
Plane = Plano
Non-Signal = Sem-sinal
Other = Outro
Please delete all the objects of the layers first! The layers are: = Por favor delete todos objetos da camada primeiro! As camadas são:
You are converting Signal Layer to Plane Layer, There're some non-track objects remain on following layers. Please delete the objects manually on the canvas. =
Please delete all the objects of this layer first! = Por favor apague todos objetos dessa camada primeiro!

#Dialog Fabrication Output
Create Files = Criar arquivos
Check your {0}Gerber files{1} carefully before sending them to the factory = Verifique seus {0} arquivos Gerber {1} cuidadosamente antes de enviá-los para a fábrica
Download free Gerber Viewer (gerbv) = Download grátis Gerber Viewer (gerbv)
Before generating the Gerber files = Antes de gerar os arquivos Gerber
Please check the packages size and orientation carefully. = Por favor, verifique o tamanho dos pacotes e orientação cuidadosamente.
Please check for Design Rule Checking (DRC) errors in the Design Manager. = Por favor, verifique os erros de Checagem de Regras de Design (DRC) no Gerenciador de Design
Please rebuild the copper area after modifying tracks and packages. = Por favor, reconstrua a área de cobre depois de modificar faixas e pacotes.
After generating the Gerber file, please use the {0}Gerber Viewer{1} to check whether it conforms to the design requirements. = Depois de gerar o arquivo Gerber, use o {0} Gerber Viewer {1} para verificar se ele está em conformidade com os requisitos de design.
Order PCB/SMT = Encomendar PCB/SMT em JLCPCB
Found the complicated polygon that object cannot be generated at Gerber, please remove or replace =
ID: {id}, Object: {object}, Location: {location} =

#Dialog DRC
Item = Item
Value = Valor
value = valor
Unit = Unidade
Track Width = Largura da trilha
Track to Track = Trilha para Trilha
Track to Pad = Trilha para Pad
Pad to Pad = Pad para Pad
Via to Via = Via a Via
Via Hole Size = Tamanho do furo de Via
Realtime DRC = DRC em tempo real
{0} is too small! = {0} é muito pequeno!
Invalid DRC Rule = Regra de DRC Inválida
Rule = Regra
Via Diameter = Via Diâmetro
Via Drill Diameter = Diâmetro do furo da Via
Net List = Lista Net
Rule = Regra
Set Rule = Definir Regra
Check Object to Copper Area =
Show DRC Boundary while Routing =
Check Object to Board Outline =
Rule name already exists! = O nome da regra já existe!
You should not delete default rule! = Você não deve excluir a regra padrão!
Rule list contains invalid rule setting! = Lista de regras contém configurações de regras inválidas!
Duplicate rule name exists! = Existe um nome de regra duplicado!
via diameter is smaller than via drill diameter! = via diâmetro é menor do que através do diâmetro da broca!
Currently rule name is not allowed to contain magical characters like . and $ = Atualmente não é permitido que regra de nome contenha caractéres magicos como . e $
[drcRule]
All = Tudo
[/drcRule]

#Dialog  Update PCB
Update PCB(Synchronizing PCB from schematics) = Atualizar PCB (Sincronizando PCB do esquema)


#Dialog Hotkey
Change Canvas Unit = Mudar Unidade da Tela
Copy Selected Object(s) by Reference Point = Copiar Objeto(s) Selecionado(s) por Ponto de Referência
Fullscreen = Tela Cheia
Undo the Previous Draw = Desfazer o Desenho Anterior
Set Canvas Origin by Coordinate = Definir Origem da Tela por Coordenada
Switch to the Next Signal Layer = Mudar para Próxima Camada de Sinal
Switch to the Previous Signal Layer = Mudar para Camada de Sinal Anterior
Switch object to top layer or bottom layer = Mudar objeto para camada de baixo ou de cima
Cycle Forward to the Next Open Tabbed Document = Alternar para a Próxima Aba com um Documento Aberto de forma Cíclica
Cycle Backward to the Previous Open Tabbed Document = Alternar para a Aba com um Documento Aberto Anterior de forma Cíclica
Switch to the Previous Layer(on the Numeric Keypad) = Mudar para Camada Anterior(no Teclado Numérico)
Switch to the Next Layer(on the Numeric Keypad) = Mudara para Próxima Camada(no Teclado Numérico)
Toggle Layers Which is Not Active = Ocultar Camadas que não estão Ativas
Hotkey Setting = Configuração de atalho
Document Type = Tipo de Documento
Shortcut = Atalho
Function = Função
ALL = ALL
SCH = SCH
Rotate Selected Objects = Rotacionar Objetos Selecionados
Scroll or Move Selected Left = Rolar Tela ou Mover Seleção para esquerda
Scroll or Move Selected Right = Rolar Tela ou Mover Seleção para direita
Scroll or Move Selected Up = Rolar Tela ou Mover Seleção para cima
Scroll or Move Selected Down = Rolar Tela ou Mover Seleção para baixo
Set canvas origin to the center grid of graphics in symbol; Set canvas origin to the center of pads in footprint. = Posicionar a origem da tela no ponto da grade ao centro dos traços do símbolo; Posicionar a origem da tela no ponto da grade ao centro das ilhas do footprint.
Cross Document Paste = Colar documento cruzado
Explore & Find Components = Explorar e Encontrar Componentes
Select All = Selecione tudo
Cancel Current Drawing = Cancelar Desenho Atual
Save = Salvar
Drag Tool = Ferramenta de Arrastar
Draw Wire = Desenhar Fio
Draw Bus = Desenhar Barramento
Bus Entry = Entrada de Barramento
Junction = Junção
Net Flag GND = Rótulo de Rede GND
Net Flag = Rótulo de Rede
Draw Polyline = Desenhar Polilinha
Draw Polygon = Desenhar Polígono
Draw Bezier = Desenhar Bézier
Draw Arc = Desenhar Arco
Draw Rect = Desenho Retificado
Draw Ellipse = Desenhar Elipse
Freehand Draw = Desenhar Mãos Livres
Freedraw = Desenho Livre
Draw Text = Desenhar Texto
Edit Selected Symbol = Editar símbolo selecionado
Draw Track = Desenhar Trilha
Draw Circle = Desenhar Círculo
Cycle Select Object at Current Location =
Draw Dimension = Desenhar Dimensão
Draw Connect = Desenhar Conectar
Draw CopperArea = Desenhar CopperArea
Change to TopLayer;<br/>Change Selected Component's Layer to TopLayer; = Mudar para a Camada Superior; Mudar a Camada dos Componentes Selecionados para a Camada Superior;
Change to BottomLayer;<br/>Change Selected Component's Layer to BottomLayer; = Mudar para a Camada Inferior; Mudar a Camada dos Componentes Selecionados para a Camada Inferior;
Change to Inner1 = Mudar para Interna1
Change to Inner2 = Mudar para Interna2
Change to Inner3 = Mudar para Interna3
Change to Inner4 = Mudar para Interna4
Highlight Net = Destaque Net
Place Pad = Coloque o Pad
Place Via = Coloque Via
Measure = Medida
Change Routing Angle = Alterar o Ângulo de Roteamento
Change Routing Conflict = Alterar Conflito de Roteamento
Decrease Routing Width = Diminuir Largura de Roteamento
Increase Routing Width = Aumentar Largura de Roteamento
Decrease Snap Size = Diminuir tamanho do Snap
Increase Snap Size = Aumentar Tamanho do Snap
Change Copper Zone Visible or Invisible = Mudar Zona de Cobre Visível ou Invisível
Rebuild All Copper Area = Reconstruir toda a área de cobre
Toggle PCB Net Display = Alternar exibição de rede PCB
Show Property Dialog When Placing Object;<br/>Show Location Setting Dialog When Pasting Object(s) =
Show Property Dialog When Placing Object;<br/>Show Absolute Offset Dialog When Selecting Object(s);<br/>Show Location Setting Dialog When Pasting Object(s) =
Show Relative Offset Dialog When Selecting Object(s) =
Open the FAQ Page = Abrir Página do FAQ
Move Object(s) by Reference Point = Mover Objeto(s) por Ponto de Referência
Choose Favorite Track Width While Routing = Selecionar Largura de Trilha Favorita Enquanto estiver Roteando
Copy Selected Object(s) and Paste Repeatedly = Copiar Objeto(s) Selecionado(s) e Colar Repetidamente

#My Projects Tree Menu
New Project = Novo projeto
New Schematic = Novo esquema
New PCB = Novo PCB
New Spice Subckt = New Spice Subckt
Modify = Modificar
Delete = Deletar
Add sub part = Adicionar subpartição
Clone = Clonar
Version History = Histórico de versões
Refresh List = Atualizar lista
Create New Project = Criar novo projeto
Delete = Deletar
Attachment = Anexar Arquivos
Archive = Arquivar
Transfer = Transferir
Manage Project =

#Dialog Verify Package
Footprints Verification = Verificação de Footprints

#Dialog Edit Polygon Pad points
Edit Points = Editar pontos
Center point is outside the pad = Ponto central está fora da ilha
Hole should be inside the pad = Furo deveria estar dentro da ilha
Hole is draggable = Furo é arrastável

#My Part Tree Menu
Clone = Clonar
Reload parts = Recarregar peças
Layers = Camadas

#Dialog Preferences
Language = Idioma
Display Name = Nome de exibição
HotKey Sync = Sincronização das Teclas de Atalho
My Theme Sync = Minha sincronia de tema
Document Recovery Setting = Configuração de Recuperação de Documentos
Enable auto backup = Habilitar backup automático
Maximum backup level = Nível máximo de backup
Auto backup interval = Intervalo de backup automático
minutes = minutos
Save to Server = Salvar no servidor
Load from Server = Carregar do servidor


#Dialog Schematic Library Wizard
Symbol Wizard = Wizard de Símbolo
Style = Estilo
Picture = Quadro
Pin Names = Nomes dos Pinos
Contributor = Colaborador
contributor = contribuidor
owner = dono

#Dialog Annotate
Annotate = Anotar
Scope = Escopo
Active Schematic only = Esquema Ativo apenas
All Opened Schematics = Todos os esquemas abertos
Method = Método
Re-annotate all = Re-anotar todos
Keep existing annotation = Manter anotação existente
Direction = Direção
Rows = Linhas
Cols = Colunas
Reset = Reset

#Dialog Order
Order... = Ordem...
PCB Qty. = PCB Qtd.
PCB Thickness = Espessura do PCB
PCB Dimension = Dimensão PCB
Automatic calculation = Cálculo Automático
PCB Color = PCB Color
Green = Verde
White = Branco
Blue = Azul
Red = Vermelho
Yellow = Amarelo
Black = Preto
Purple = Roxo
Copper = Cobre
Gold = Ouro
Silver = Prata
Surface Finish = Acabamento de Superfície
Hasl = Hasl
Hasl(Lead Free) = Hasl (sem chumbo)
ENIG = ENIG

#Dialog Hot Key config
Restore All Default Shortcuts = Restaurar todos os atalhos padrão
Save Changes = Salvar alterações



#Dialog Polyline Maybe Wire
To connect electrical elements, please use Wire (W hotkey) and not Line (L hotkey). = Para conectar elementos elétricos, use Wire (tecla de atalho W) e não Line (tecla de atalho L).

Anonymous File = Arquivo anônimo
Anonymous File can not be cloned, but you can open it, then save it as a new file. = Arquivo anônimo não pode ser clonado, mas você pode abri-lo e salvá-lo como um novo arquivo.
Free Documents = Documentos Livres
You must close the file before delete it! = Você deve fechar o arquivo antes de excluí-lo!
Offline Project = Projeto Offline

#Message box
Confirmation = Confirmação
Alert = Alerta
Information = Informação
information = informação
Prompt = Prompt
Error = Erro
error = erro
error! = erro!
Warning = Aviso
Imported ok! = Importado ok!
Some changes have not been saved. = Algumas alterações não foram salvas.
Your file hasn't been saved. Please save first! = Seu arquivo não foi salvo. Por favor, salve primeiro!
Your file hasn't been saved. Are you sure you want to close it? = Seu arquivo não foi salvo. Tem certeza de que deseja fechá-lo?
Error! Please try again later. = Erro! Por favor, tente novamente mais tarde.
Are you sure you want to reload this page? = Tem certeza de que deseja recarregar esta página?
Are you sure you want to leave this page? = Tem certeza de que deseja sair desta página?
Confirm Reload = Confirme Recarregar
Confirm Close = Confirme Fechar
Reload this page = Recarregar essa página
Leave this page = Deixar esta página
Stay on this page = Fique nessa página
Don't reload = Não recarregue
No connect flag only can be placed on Pin dot or the wire which is connected one Pin. =
can not be placed on the wire which is placing No Connect Flag. =
The footprint transfer to LCSC library class successfully =
Device/Footprint goes into "SMT Device/Footprint Verified" list successfully =

Load failure! = Falha de carga!
Load projects failed = Falha ao carregar projetos
error info = informação de erro
error information = informação de erro
Guest can't create a new project. Please login! = O convidado não pode criar um novo projeto. Por favor, faça login!
Please create a project before you do this! = Por favor, crie um projeto antes de fazer isso!
Add Part success = Sucesso ao adicionar parte
Click the new part and then edit it! = Clique na nova parte e edite-a!
Delete my work = Excluir meu trabalho
Delete my work. (Only deletes it from this list but not from the server) = Excluir meu trabalho. (Exclui apenas desta lista, mas não do servidor)
Do you confirm this? = Você confirma isso?
Successfully deleted! = Excluído com sucesso!
Successfully Copied! = Copiado com Sucesso!
Cloning success! = Sucesso ao clonar!
Your title is too short! = Seu título é muito curto!
Remove this part = Remover esta parte
Find and Jump to ... = Encontre e pule para ...
Please type the prefix, such as U1, R1, C1 = Por favor digite o prefixo, como U1, R1, C1
Zoom as 1:1, you can print it and then create artwork for etching the PCB. = Zoom como 1: 1, você pode imprimi-lo e, em seguida, criar obras de arte para gravar o PCB.
Exporting your works! = Exportando seus trabalhos!
Guests can't import a file. Please login! = Os convidados não podem importar um arquivo. Por favor entre!
Please create a project before you import a file! = Por favor, crie um projeto antes de importar um arquivo!
Import your LTspice file! = Importe seu arquivo LTspice!
Open LTspice file = Abrir arquivo LTspice
Please make sure the selected LTspice file is a file saved in LTspice V and above. =
Saved successfully! = Salvo com sucesso!
Save failed! = Falha ao salvar!
Can not place parts into this document. = Não é possível colocar peças neste documento.
User Package = Pacote de Usuários
System Package = Pacote de sistema
File error = Erro de arquivo
Please save your file first! = Por favor, salve seu arquivo primeiro!
Email address is too short! = Endereço de email é muito curto!
You have not selected a file to upload. = Você não selecionou um arquivo para upload.
Update = Atualizar
No changes, the PCB already matches the schematic! = Sem mudanças, a PCB já corresponde com o esquemático!
Only public files can be shared = Somente arquivos públicos podem ser compartilhados
Conversion to PCB has failed! = Conversão para PCB falhou!
Your username is too short! = Seu nome de usuário é muito curto!
Your password is too short, it must be more than 6 characters! = Sua senha é muito curta, esta deve ter mais de 6 caracteres!
Conflicting shortcut = Atalho conflitante
There is an empty PCB file. Please first run Convert Schematic to PCB... from the schematic = Existe um arquivo PCB vazio. Por favor, primeiro execute Converter Projeto para PCB... do esquema
This file has been modified, are you sure you want to run this simulation before saving it first? = Este arquivo foi modificado. Tem certeza de que deseja executar esta simulação antes de salvá-lo primeiro?
Please enter the Maximum Timestep! = Por favor, insira o Timestep máximo!
Please enter the Stop Time! = Por favor, insira a Hora de Parada!
All of these fields are needed. = Todos esses campos são necessários.
Either your spice netlist is too big or the server is busy. Please try again later. = A sua netlist Spice é muito grande ou o servidor está ocupado. Por favor, tente novamente mais tarde.
Your spice netlist is too big! Try breaking your circuit into smaller simulatable blocks. = Sua netlist Spice é muito grande! Tente quebrar seu circuito em pequenos blocos simuláveis.
Too many users in simulation. Please try again later! = Muitos usuários na simulação. Por favor, tente novamente mais tarde!
Due to limited server resources, please wait 10 seconds for the interval in every time simulation. = Devido a recursos limitados dos servidores, por favor aguarde 10 segundos para o intervalo entre cada simulação temporal.
Your circuit is too complex, we have not enough CPU resource to support this simulation, please reduce your circuit as small as you can. = Seu circuito é complexo demais, não temos recursos de CPU suficientes para suportar esta simulação. Por favor, reduza seu circuito e deixe-o tão pequeno quanto puder.
Simulation is queuing, try again after 30s. =
Timeout =
Demo accounts don't support simulation, please login first = Contas demo não suportam simulação, por favor faça o login primeiro
Please login first = Por favor, faça o login primeiro
The schematic is showing errors, please check the simulation report carefully! = O esquema está mostrando erros, por favor, verifique o relatório de simulação com cuidado!
Simulation too long, maybe your schematic is too complex. = Simulação por muito tempo, talvez seu esquema seja complexo demais.
Non-simulated file =
This file can only be opened in standard mode. To open it, please switch to standard mode. = Este arquivo só pode ser aberto no modo padrão. Para abri-lo, por favor troque para o modo padrão.
Load your preferences success! = Preferências carregadas com sucesso!
Save your preferences success! = Preferências salvas com sucesso!
Update subckt ok! = Atualizar subckt ok!
Clone your file = Clone seu arquivo
Please type a new file name = Por favor digite um novo nome de arquivo
Create file failure! = Criar falha no arquivo!
Schematics and PCBs can't be imported under My Libs folder, please choose a different folder = Esquemas e PCBs não podem ser importados na pasta My Libs, por favor escolha uma pasta diferente
Libraries to be imported under My Libs folder = Bibliotecas a serem importadas na pasta My Libs
Please choose only the libraries needed = Por favor, escolha apenas as bibliotecas necessárias
Maximum import is 200 libs at one time! = A importação máxima é de 200 libs ao mesmo tempo!
You libraries will be found under the My Libs folder =
Add to Library = Adicionar à Biblioteca
No items have been checked! = Nenhum item foi verificado!
Nothing was found, please create it for yourself = Nada foi encontrado, por favor crie para você
Search result = Resultado da pesquisa
At least 3 characters needed = Pelo menos 3 caracteres necessários
Add to my Favorite Parts = Adicionar às minhas partes favoritas
Added it OK. Please find it in your Favorite Parts = Adicionado OK. Por favor, encontre nas suas Partes Favoritas
Please select its parent node = Por favor, selecione seu nó pai
Libraries can not be exported as active project pdf. = Bibliotecas não podem ser exportadas como projeto ativo pdf.
Error:No GND =
This circuit does not have GND. Please select GND from the circuit tool to add to the circuit. = Este circuito não possui GND. Por favor, selecione GND a partir das ferramentas de circuito para adicioná-lo ao circuito.
Current circuit doesn't has Voltage Resource or Current Resource symbol, please place it first at left side EElib or Spice Library. = O circuito atual não possui símbolos de Fonte de Tensão ou de Fonte de Corrente. Por favor, coloque ao menos um deles antes utilizando EElib ou Biblioteca Spice à esquerda da janela.
Probe can not connect with ground(GND)! = Sonda não pode ser conectada ao ground(GND)
Spice symbols's properties can't be empty. =
Error:No Spice Symbol =
Simulation limit = Limite de Simulação
There is a multimeter in the circuit that needs to be simulated using the emulation command .tran or .op = Há um multímetro no circuito que precisa ser simulado utilizando o comando de emulação .tran ou .op
An oscilloscope exists in the circuit and needs to be simulated using the simulation command .tran = Existe um osciloscópio no circuito e ele precisa ser simulado utilizando o comando .tran
There are components in this circuit that do not have a simulation model. Please use the base library component of the simulation mode for simulation. =
Circuit does not have a probe = Circuito não tem uma sonda
Make sure your pin numbers are even numbers = Certifique-se de que seus números de pin são números pares
Duplicate Components Prefix = Prefixo de Componentes Duplicados
All components are hidden successfully! = Todos componentes foram escondidos com sucesso!
All ratlines are hidden successfully! =
Hidden the ratline of net {netName} successfully! =
Duplicate Component Prefix = Duplicar Prefixo do Componente
{0} exist = {0} existe
There are some invalid packages, are you sure? = Existem alguns pacotes inválidos, tem certeza?
Invalid Characters, library only allows [0-9a-zA-Z-_]
Annotation success = Anotação de sucesso
If you accept this annotation operation, please save your files. If not, close your files without saving. = Se você aceitar esta operação de anotação, salve seus arquivos. Se não, feche seus arquivos sem salvar.
This file can't be saved under libs project. Please choose other project or create a new project = Este arquivo não pode ser salvo no projeto libs. Por favor, escolha outro projeto ou crie um novo projeto
Your file is unsaved. = Seu arquivo não está salvo.
You can close the editor now. Have a good day! = Você pode fechar o editor agora. Tenha um bom dia!
Successfully logged out = Logout com êxito
You have at least one unsaved file open. Please save it or close it. = Você tem pelo menos um arquivo não salvo aberto. Por favor salve ou feche.
Please select a reference point = Por favor, selecione um ponto de referência
Please save your file before this operation = Por favor, salve seu arquivo antes desta operação
Please open a PCB document = Por favor, abra um documento PCB
Please save your file before '{0}'. = Por favor, salve seu arquivo antes de '{0}'.
Please try again after saving this file. = Por favor, tente novamente depois de salvar este arquivo.
This text can not be empty! = Esse texto não pode ficar vazio!
Export to Altium fail, please try again or contact us. = Falha ao exportar para o Altium, por favor tente novamente ou entre em contato conosco.
Connecting to server = Conectando ao servidor
Please login before asking for help = Por favor, faça o login antes de pedir ajuda
This file has been modified, please save it first! = Este arquivo foi modificado, salve-o primeiro!
Remove this param = Remova este parâmetro
You cannot drag a part to the canvas, please click the part and move the cursor to the canvas and then right-click to place. =
Undo/Redo temporary error = Erro temporário de desfazer / refazer
We are sorry but there is an unpredictable error in the undo/redo process. This problem will be fixed soon but in the meanwhile it is safe to continue working on your design. =
The schematic has duplicate prefixes of the components, please make them unique. You can check them using the Design Manager. = O esquema tem prefixos duplicados dos componentes, por favor, os torne únicos. Você pode verificá-los usando o Gerenciador de Design.
Found duplicated prefix components, can not Import Changes, please modify the duplicated prefix or delete related component. =
Please click the below help button to find out how to fix this problem. = Por favor, clique no botão de ajuda abaixo para descobrir como corrigir esse problema.
Please create a board outline! Click the help button to find out how to create a board outline. = Por favor, crie um contorno da placa! Clique no botão de ajuda para descobrir como criar um contorno da placa.
Can not fetch files from server, please check your network and try again = Não é possível recuperar arquivos do servidor, verifique sua rede e tente novamente
Please open a schematic first! = Por favor, abra um esquema primeiro!
Can not find the schematic of this PCB = Não é possível encontrar o esquema deste PCB
invalid points! = pontos inválidos!
This file does not support this operation. = Este arquivo não suporta esta operação.
Net Name Conflict = Conflito de nome de rede
Net name = Nome da rede
{0} are in the same wire, please remove others and just keep one. = {0} estão no mesmo fio, por favor remova os outros e mantenha apenas um.
This field can't be removed! = Este campo não pode ser removido!
Annular ring of the pad/via is too small = Anel de contorno da ilha / via é muito pequeno
The size of the hole cannot exceed the size of the pad = O tamanho do furo não pod exceder o tamanho da ilha
Are you sure you want to create a multi-sheet designs? = Tem certeza de que deseja criar um design de várias folhas?
Are you sure you want to create a {0}multi-sheet designs{1}? = Tem certeza de que deseja criar {0} designs de várias folhas {1}?
Please build the copper area! Click the help button to find out how to build the copper area. = Por favor, construa a área de cobre! Clique no botão de ajuda para descobrir como construir a área de cobre.
Suggest to set a package for this component first! =
Please select an opened document first. = Por favor, selecione um documento aberto primeiro.
Some files failed to load. Please reload the page. = Alguns arquivos não foram carregados. Por favor recarregue a página.

#UI Intro
Skip = Pular
« Back = « Voltar
Next » = Próximo »
Done = Pronto
This is the user management menu. = Este é o menu de gerenciamento de usuários.
This is the toolbar. = Esta é a barra de ferramentas.
This is the navigation list. Under here you can find projects, files, parts and libraries. = Esta é a lista de navegação. Abaixo você pode encontrar projetos, arquivos, partes e bibliotecas.
Show or hide the toolbar to the top of the window here. = Mostrar ou ocultar a barra de ferramentas na parte superior da janela aqui.
Show, resize or hide the left sidebar to the left of the window here. = Mostrar, redimensionar ou ocultar a barra lateral esquerda à esquerda da janela aqui.
Show or hide the right sidebar to the right of the window here. = Mostre ou oculte a barra lateral direita à direita da janela aqui.

#Standard libs
Passive Components = Componentes passivos
Power Supply = Fonte de Alimentação
Diodes = Diodos
Regulator = Regulador
Transistor = Transistor
Transformers = Transformadores
Gates = Portões
Vacuum Tubes = Tubos de vácuo
Switch = Switch
Relay = Relé
Capacitor(US) = Capacitor (EUA)
Capacitor(EU) = Capacitor (UE)
Capacitor(EU)2 = Capacitor (UE) 2
Electrolytic Capacitor(US) = Capacitor eletrolítico (US)
Electrolytic Capacitor(EU) = Capacitor eletrolítico (UE)
Electrolytic Capacitor(US)2 = Capacitor eletrolítico (US) 2
Electrolytic Capacitor(EU)2 = Capacitor eletrolítico (UE) 2
Inductor(US) = Indutor (EUA)
Inductor(EU) = Indutor (UE)
Potentiometer_US = Potenciômetro_US
Potentiometer_EU/IEC = Potenciômetro_EU/IEC
Potentiometer_3D = Potenciômetro_3D
Resistor(US) = Resistor (EUA)
Resistor(EU) = Resistor (EU)
Resistor 45 Deg(US) = Resistor 45 Deg (US)
Resistor 45 Deg(EU) = Resistor 45 Deg (EU)
Variable Capacitor(US) = Capacitor Variável (US)
Variable Capacitor(EU) = Capacitor Variável (UE)
Variable Resistor(US) = Resistor Variável (US)
Variable Resistor(EU) = Resistor Variável (UE)
Variable Inductor(US) = Indutor Variável (US)
Variable Inductor(EU) = Indutor Variável (UE)
Varistor = Varistor
Inductor2(US) = Inductor2 (US)
Inductor2(EU) = Inductor2 (EU)
Battery = Bateria
Voltage Source = Fonte de Tensão
Current Source = Fonte de Corrente
CCCS(Current Controlled Current Source) = CCCS (fonte de corrente controlada)
CCCS2(Current Controlled Current Source) = CCCS2 (fonte de corrente controlada)
VCCS(Voltage Controlled Current Source) = VCCS (fonte de corrente controlada por tensão)
VCVS(Voltage Controlled Voltage Source) = VCVS (fonte de corrente controlada por tensão)
CCVS(Current Controlled Voltage Source) = CCVS (fonte de tensão controlada por corrente)
CCVS2(Current Controlled Voltage Source) = CCVS2 (fonte de tensão controlada por corrente)

BV(Behavioral Voltage Sources) = BV (Fontes de Voltagem Comportamental)
BI(Behavioral Voltage Sources) = BI (Fontes de Voltagem Comportamental)
Epoly(Non-linear Voltage Source) = Epoly (fonte de tensão não linear)
Gpoly(Non-linear Current Source) = Gpoly (fonte de corrente não linear)

Diode = Diodo
LED = LED
LED_3D = LED_3D
Schottky Diode = Diodo Schottky
Varactor Diode = Diodo Varactor
Zener = Zener
Unidirectional TVS Diode = Diodo de TVS unidirecional
Bidirectional TVS Diode = Diodo de TVS bidirecional
Diac = Diac
Bridge = Ponte
78XX = 78XX
79XX = 79XX
LM317 = LM317
LM337 = LM337
TL431 = TL431
BJT(NPN) = BJT (NPN)
BJT(PNP) = BJT (PNP)
MOSFET(Nch) = MOSFET (Nch)
MOSFET(Nch) Depletion Four-pins = MOSFET (Nch) Desvio Quatro pinos
MOSFET(Nch) Enhancement = MOSFET (Nch) Aprimoramento
MOSFET(Nch) Enhancement Four-pins = MOSFET (Nch) Potência Quatro pinos
MOSFET(Pch) = MOSFET (Pch)
MOSFET(Pch) Depletion Four-pins = MOSFET (Pch) Desvio Quatro pinos
MOSFET(Pch) Enhancement = MOSFET (Pch) Aprimoramento
MOSFET(Pch) Enhancement Four-pins = MOSFET (Pch) Potência Quatro pinos
JFET(Nch) = JFET (Nch)
JFET(Pch) = JFET (Pch)
Darlington NPN = Darlington NPN
Darlington PNP = Darlington PNP
MESFET(Nch) = MESFET (Nch)
MESFET(Pch) = MESFET (Pch)

IGBT = IGBT
SCR = SCR
Triac = Triac
Transform(US) = Transformador (US)
Transform(EU) = Transformador (UE)
Transfrom(NEUTRAL-CTR TAP)(US) = Transfromador (NEUTRAL-CTR TAP) (US)
Transfrom(NEUTRAL-CTR TAP)(EU) = Transfromador (NEUTRAL-CTR TAP) (EU)
Mutual Inductors = Indutores Mútuos
Mutual Inductors2 = Indutores Mútuos2
Or Gate = Porta Or
Xor Gate = Porta Xor
And Gate = Porta And
Nor Gate = Porta Nor
Nand Gate = Porta Nand
Not Gate = Porta Not
Xnor Gate = Porta Xnor
Tube Diode = Tube Diode
Tube Triode = Tube Triode
Tube Tetrode = Tube Tetrode
Tube Pentode = Tube Pentode
Voltage Controlled Switch = Interruptor Controlado por Voltagem
Current Controlled Switch = Interruptor Controlado por Corrente
SPST ON = SPST ON
SPST OFF = SPST OFF
Fuse = Fusível
555 = 555
555(Style2) = 555 (Style2)
Speaker = Speaker
XTAL = XTAL
5pin Operational Amplifier = Amplificador Operacional de 5 pinos
3pin Operational amplifier = Amplificador operacional de 3 pinos
Transmission Line = Linha de Transmissão
Voltmeter = Voltímetro
Ammeter = Amperímetro
LAMP = Lâmpada
Opto Transistor = Transistor Opto

#Server Message
Need login = Precisa de login
Bad password = Senha incorreta
We can't find your username or your email, please check it! = Não encontramos o seu nome de usuário ou seu email, por favor, verifique!
Make sure your uploaded file size is less than 3MB! = Verifique se o tamanho do arquivo enviado é menor que 3 MB!
Bad file type = Tipo de arquivo incorreto
Empty file or bad file type, ensure your file is Eagle 6.0+ = Arquivo vazio ou tipo de arquivo inválido, garanta que seu arquivo seja Eagle 6.0+
This operation not supported on demo account = Esta operação não é suportada na conta de demonstração
Can not share this file under a private project, please set the active project to public! = Não é possível compartilhar este arquivo em um projeto privado, por favor, defina o projeto ativo para público!
Login Failed Too many attempts. If you forgot your password, please {0}reset your password{1} or send an email to support@easyeda.com = Falha no login. Muitas tentativas. Se você esqueceu sua senha, {0} redefina sua senha {1} ou envie um email para support@easyeda.com

#Dialog Common Buttons
Common Buttons Setting = Configuração de Botões Comuns
Menu Setting... = Configuração de Menu...
Show/Hide = Mostrar / Esconder
Move Up = Mover para Cima
Move Down = Mover para baixo
Reset All = Repor tudo
Zoom = Zoom
Place Pin = Coloque o Pin

#System Setting Dialog
System = Sistema
Zoom Mode = Modo de Zoom
Scroll Key = Tecla de Rolagem do Mouse
CTRL + Scroll = CTRL + Rolagem
Canvas Coordinate System = Sistema de Coordenadas da Tela
SVG Coordinate = Coordenadas SVG
Cartesian Coordinate = Coordenadas Cartesianas
Open Wizard Dialog for New Schematic =
Default Unit = Unidade Padrão
Canvas Zoom Effect = Efeito do Zoom na Tela
Quality Priority = Priorizar Qualidade
Speed Priority = Priorizar Velocidade
Rotation Step = Passo de Rotação
Add Teardrop Automatically =
Assign Net for Free Track/Arc/Circle =
Open Wizard Dialog for New PCB =
Rebuild Plane Automatically = Refazer plano automaticamente
The Track's Routing Follows Component's Rotation = O Roteamento das Trilhas acompanha a Rotação do Componente
Display Pad's Number and Net = Mostrar Número e Rede das Ilhas
Favorite Track width = Largura de Trilha favorita
Track Width Setting = Configuração de Largura de Trilha


#Dialog Access Control
Permissions = Permissões
Operations = Operação
Access Control = Controle de acesso
Project Access Control = Projeto de Controle de acesso
Reject = Rejeitar
Add User = Adicionar usuário
Bad email address = Endereço de email incorreto
# error info from backend
Can't find this email address in EasyEDA. Your partner must be an EasyEDA user. = Não foi possível encontrar este endereço de e-mail no EasyEDA. Seu parceiro deve ser um usuário EasyEDA.

#Dialog waveForm
Grid Background = Contexto da Grade
Pane Background = Painel Background
WaveForm Config = Configuração da Forma de Onda
Export Waveform = Exportar forma de onda


#attr-canvas-grid-style
dot = ponto
line = linha

#attr-canvas-frame-size
Other = Outro
A4 Portrait = A4 retrato
A4 Landscape = Paisagem A4
A3 Portrait = A3 retrato
A3 Landscape = A3 paisagem
A2 Portrait = A2 Retrato
A2 Landscape = A2 paisagem
A1 Portrait = A1 retrato
A1 Landscape = A1 paisagem
Landscape = Paisagem
Portrait = Retrato

#Stroke Style
solid = sólido
dashed = tracejado
dotted = pontilhado

#Solid Region
Solid Region = Região Sólida
Type = Type
type = type

#Dialog Libs Management
Report error = Reportar erro
Please give us some information to help us find the problem. = Por favor, nos dê algumas informações para nos ajudar a encontrar o problema.
Cannot place parts into this document: Schematic Symbols can only be placed into a Schematic; PCB Footprints can only be placed into a PCB. = Não é possível colocar partes neste documento: Símbolos esquemáticos só podem ser colocados em um esquema; Pegadas PCB só podem ser colocadas em um PCB.
Save it as a favorite part = Salve como parte favorita
Only logged-in users can save this component as a Favorite Part but guest (Anonymous) users can place this component into their design directly. Would you like to place this component now? = Somente usuários conectados podem salvar este componente como uma Parte Favorita, mas os usuários convidados (Anônimos) podem colocar esse componente diretamente em seu design. Você gostaria de colocar este componente agora?

#Others
Find libs = Encontre libs
My Projects = Meus projetos
My Parts = Minhas partes
My Modules = Meus módulos
Assembly LCSC Components = Componentes de Montagem da LCSC
Modules = Módulos
SCH Module = Módulo SCH
PCB Module = Módulo PCB
System IC = IC do sistema
LCSC (Official) = LCSC (oficial)
LCSC Electronics =  LCSC
Simple Mode = Modo Simples
Expand Mode = Modo Expandido
Help Verify = Verificar Ajuda
Favorite Parts = Partes Favoritas
Shared With Me = Compartilhado Comigo
Preview = Visualizar
Preview Window = Janela de pré-visualização
System Default = Padrão do sistema
User Defined = Definido pelo usuário
Theme = Tema
Theme Setting = Definição de Tema
Close = Fechar
Open = Abrir
Toggle toolbar = Barra de alternância
Toggle left bar = Alternar barra esquerda
Toggle right bar = Alternar barra direita
Reload = Recarregar
Mouse-X = Mouse-X
Mouse-Y = Mouse-Y
Mouse-DX = Mouse-DX
Mouse-DY = Mouse-DY
Bus entry x1 = Entrada de barramento x1
Bus entry x2 = Entrada de barramento x2
Bus entry y1 = Entrada de barramento y1
Bus entry y2 = Entrada de barramento y2
Yes = Sim
No = Não
OK = OK
Confirm = Confirmar
Continue = Continue
Cancel = Cancelar
Update = Atualizar
Bus entry = Entrada de ônibus
Filter = Filtro
Check = Check
Copy the contents of this box into a text editor, then save the file. Paste the edited text back into this box and click Apply to update the display. = Copie o conteúdo dessa caixa em um editor de texto e salve o arquivo. Cole o texto editado de volta nesta caixa e clique em Aplicar para atualizar a exibição.
Copy the contents of this box into a text editor, then save the file with a .svg extension. You can edit it in Inkscape or open it in your browser. = Copie o conteúdo dessa caixa em um editor de texto e salve o arquivo com uma extensão .svg. Você pode editá-lo no Inkscape ou abri-lo no seu navegador.
Content is too big to show, you can download it directly. = O conteúdo é muito grande para mostrar, você pode baixá-lo diretamente.
SVG format = Formato SVG
SVG File = Arquivo SVG
Description should be no more than 250 letters = A descrição não deve conter mais de 250 letras
The file save operation has timed out. Try again and check your Internet connection. = A operação de salvamento de arquivos atingiu o tempo limite. Tente novamente e verifique sua conexão com a Internet.
Export Netlist = Exportar Netlist
Notifications = Notificações
Please select txt or json files. = Por favor selecione arquivos txt ou json.
Failed to read file [{file}]
[{file}] is not a valid json file
Invalid parameters! = Parâmetros inválidos!
Download = Download
Start = Início
You have unsaved files, are you sure you want to log out without saving the files? = Você tem arquivos não salvos, tem certeza de que deseja sair sem salvar os arquivos?
Please use the web version to run this function. = Por favor, use a versão web para executar esta função.
Please save this file to you project! = Por favor, salve este arquivo para o seu projeto!
Nothing changed = Nada mudou
Delete Node = Excluir nó
This layer is invisible. = Essa camada é invisível.
When the solid region is Board Cutout, please set the layer to Multi-Layer. =
You should not try to assign a net to a Board Cutout solid region. =
Net Length = Comprimento Net
You can place a Pin in the schematic, but don't forget to group all of the Pins to a schematic component. Please click the help button to find out how to group them. If you just want to mark the wire, please use NetPort or NetLabel. =
Please input the modification = Por favor, insira a modificação
The content must be between {0} and {1} characters =

Coming soon = Em breve
No tool = Nenhuma ferramenta
Help us translate into your language = Ajude-nos a traduzir para o seu idioma
Pad = Pad
Via/Hole = Via / Furo
PCB Layers = Camadas de PCB
Order PCB = Pedido PCB
Share = Compartilhar
Free = Livre
Small = Pequeno
Medium = Médio
Big = Grande


Embed = Incorporar
HTML = HTML
URL = URL
BBCode = BBCode
PNG = PNG
Exporting as = Exportando como
Exporting as image = Exportando como imagem
Exporting as {0}SVG{1} file. = Exportando como {0} arquivo SVG {1}.
Exporting as pdf is recommended: pdf gives good quality printed output and a small file size. = Recomenda-se exportar como pdf: o pdf fornece saída impressa de boa qualidade e um pequeno tamanho de arquivo.
Generate PCB Fabrication File(Gerber) = Gerar Arquivo de Fabricação (Gerber)
PenWidth-Increase = Aumento da Largura da caneta

#Generate Gerber
Generate Gerber = Gerar Gerber
Gerber View = Visualizar Gerber
Dimensions(Estimated) = Dimensões (estimado)
PCB Qty = PCB Qtd
Copper Weight = Peso do Cobre
PCB Price = Preço do PCB
Estimated Delivery Time = Tempo estimado de entrega

HASL(with lead) = HASL (com chumbo)
LeadFree HASL-RoHS = LeadFree HASL-RoHS
ENIG-RoHS = ENIG-RoHS
Would you like to do Design Rule Checking (DRC) before generating the Gerber files? = Gostaria de fazer uma Verificação das Regras de Design (DRC) antes de gerar os arquivos Gerber?
Yes, Check DRC = Sim, verificar DRC
No, Generate Gerber = Não, Gerar Gerber
This PCB has uncompleted connection(s), do you want to check the connection(s)? = Este PCB possui conexão(ões) incompleta(s). Gostaria de verificar a(s) conexão(ões)?
Yes, Check Connection(s) = Sim, Verificar Conexões
It will then redirect to the web site of a third-party JLCPCB with which we cooperate. Are you ready? = Em seguida, ele será redirecionado para o site do terceiro JLCPCB com o qual nós cooperamos. Você está pronto?
Failed to submit your order, please contact us via support@easyeda.com for help. = Houve uma falha ao enviar seu pedido, entre em contato conosco pelo e-mail support@easyeda.com para obter ajuda.
Failed to submit your order, please contact us via QQ 800821856. = Houve uma falha ao enviar seu pedido. Por favor entre em contato via QQ 800821856
Order data generated finish, please click OK button and continue. =
[generateGerber]
Layers = Camadas
[/generateGerber]

[version]
Switch = Switch
[/version]


Export your file, then print it yourself. = Exporte seu arquivo e imprima você mesmo.
Trace width is too small = A largura do traço é muito pequena
Share = Compartilhar

Images Property = Atributo de Imagens
Connect Pad to Pad = Conecte o Pad ao Pad
Copper Area = Área de Cobre
Dimension = Dimensão


Please check that you have used Wire and not Line to connect electrical elements. = Por favor, verifique se você usou Fio e não Linha para conectar elementos elétricos.
PCB Fabrication Prices & capabilities = Preços e capacidades de fabricação de PCBs
Flip all texts on bottom layer = Inverta todos os textos na camada inferior
Create New Document = Criar novo documento
General Package = Pacote Geral
General Packages = Pacotes Gerais
favorite Package = Pacote favorito
Board Cutout =
Surface Mount = Montagem de Superfície
JLCPCB Part Class =
base = base
expand = expandir
recommend = recomendar
Basic Part = Parte Básica
Extended Part = Parte Estendida
Recommended Part = Parte Recomendada
smtWeld =
thtWeld =
manualWeld =
furnaceWeld =
Multi-Layer = Camada Múltipla
Markdown Syntax = Sintaxe de Markdown
Markdown supported = Suporte ao Markdown
Read only = Somente leitura
Read/Write = Leitura / gravação
More Libraries... = Mais bibliotecas...
Decompress failed! = Falha na descompressão!
Load failed! = Erro de carregamento!
Loading = Carregando
No Result = Nenhum resultado

#Dialog Place Pin in schematic warning
Place Pin in schematic warning = Coloque o pino no aviso esquemático
You can place a Pin in schematic, but don't forget to group all of the Pins to a schematic component, please click the help button to find out how to group them. If you just want to mark the wire, please use NetPort or NetNabel. = Você pode colocar um Pin no esquema, mas não se esqueça de agrupar todos os pinos para um componente esquemático, por favor, clique no botão de ajuda para descobrir como agrupá-los. Se você quiser apenas marcar o fio, use NetPort ou NetNabel.
I know. Do not show this again. = Eu sei. Não mostre isso novamente.

#Extensions Setting
Extensions Setting = Configuração de Extensões
Remove = Remover
Disable = Desativar
Enable = Ativar
(Disabled) = (Desativado)
(Enabled) = (Habilitado)
Load Extension = Carregar extensão
Enable or disable will be applied after reload page = Ativar ou desativar será aplicado após recarregar a página
Your browser cannot run this function. = Seu navegador não pode executar esta função.
Your browser mode does not support indexedDB. Some features may not work properly. Are you using Private Browsing Mode? =
Extension Files = Arquivos de Extensão
Extension ID = ID de extensão
Select Files = Selecione Arquivos

#Scripts
Script = Script
Scripts = Scripts
Script Content = Conteúdo do Script
Load from js file = Carregar do arquivo js
UTF-8 encoded js file = Arquivo js codificado em UTF-8
Description = Descrição
description = descrição
Not a *.js file = Não é um arquivo *.js
Failed to read file = Falha ao ler o arquivo
System scripts cannot be modified = Scripts do sistema não podem ser modificados
Create Subfolder = Criar subpasta
Create Script = Criar Script
Install Script = Instalar script
Install = Instalar
Are you sure you want to remove this script? = Tem certeza de que deseja remover este script?
Folder Name = Nome da pasta
Rename = Renomear
Please select a script = Por favor selecione um script
Failed to load script = Falha ao carregar script
Run Script = Executar script
Load Script = Carregar Script
Title is required = Título é obrigatório
Script content is required = O conteúdo do script é obrigatório
System Scripts = Scripts do sistema
User Scripts = Scripts do usuário
You can right click on the tree nodes. = Você pode clicar com o botão direito nos nós da árvore.

#PCB photoView toolbar
Top Side = Lado Superior
Bottom Side = Lado Inferior
With Silk Layer = Com camada Silk
No Silk Layer = Sem camada Silk
Photo View = Visualização da foto

#check update
Check Update = Verificar atualização
EasyEDA Editor {ver} is released. Would you like to switch to the new version now? = O editor EasyEDA {ver} foi lançado. Gostaria de mudar para a nova versão agora?
LCEDA Editor {ver} is released. Would you like to switch to the new version now? =
Switch to New Version = Mudar para nova versão
Next Time = Outra Hora

#download project dialog
Generating download link... = Gerando link de download...
Download project now = Baixe o projeto agora

#Import DXF
Import DXF = Importar DXF
Apply Unit = Aplicar Unidade
Convert circle to HOLE on BoardOutLine layer = Trate o círculo como FURO na camada ContronoDaPlaca
No shapes found = Nenhuma forma encontrada
Fail to load the file = Falha ao carregar o arquivo
Please select a DXF file. = Por favor, selecione um arquivo DXF.
This feature only works for PCB document. = Este recurso só funciona para documentos PCB.
Select a DXF file = Selecione um arquivo DXF

#Export DXF
Export DXF = Exportar DXF
Plated-Through-Hole Pads = Ilhas Through-Hole com furo metalizado
Non-Plated-Through-Hole Pads = Ilhas Through-Hole com furo NÃO metalizado
Silkscreen =
Surface Pad = Ilha de Superfície

#Data Sync
Data Sync = Sincronização de dados
Data Conflicts = Conflitos de dados
Project or Document = Projeto ou Documento
Cloud-Side = Lado da nuvem
Local-Side = Lado Local
Decision = Decisão
Modified = Modificado
Deleted = Excluído
As Cloud = Como nuvem
As Local = Como local
Skip = Pular
Data sync completed = Sincronização de dados concluída

#Team
Team = Equipe
Teams = Equipes
Switching team = Trocando equipe
Switch team failed = Falha na troca de equipe
Load team info fail! = Falha ao carregar informações da equipe!
Load team info fail! Please reload. = Falha ao carregar informações da equipe! Por favor, recarregue.
My Teams = Minhas equipes
Create Team = Criar equipe

#Dialog Footprint Manager
Footprint Manager = Gerenciador de pegada
Open Footprint Manager = Abrir Gerenciador de Footprint
Schematic Components = Componentes esquemáticos
Edit Pin Map Information = Editar informações do mapa de pinos
Package Categories = Categorias de pacote
Components List = Lista de Componentes
Personal = Pessoal
Component PIN information = Informação do PINO do componente
Footprint PAD information = Informações sobre as ILHAS do Footprint
Footprint Categories = Categorias de Footprint
Pad Number = Número da Ilha
Search Footprint = Procurar Footprint
Filter by keyword = Filtrar por palavra-chave
System Libs = Libs do sistema

#dialog global delete
Drawings = Desenhos
Netlabel and netFlag = Netlabel e netFlag
Texts = Textos
Wires = Fios
Board outlines = Contornos da placa
Footprints = Pegadas
Footprint = Pegada
Tracks = Trilhas

#dialog board outline settings
Current Size = Tamanho Atual
Paramenters = Parâmetros
Start X: = Começar X:
Start Y: = Começar Y:
Round Rectangular =
radius = raio
only number is allowed! = somente número é permitido!
please input valid value of width! = por favor introduza um valor válido de largura!
please input valid value of height! = por favor introduza um valor válido de altura!
please input valid value of radius! = por favor introduza um valor válido de raio!

#cross probe
The object you selected was not found in other documents. = O objeto selecionado não foi encontrado em outros documentos.
No valid object for cross probe selected. = Nenhum objeto válido para a sonda cross selecionada.
Can not probe. Refreshing the window may get it to work. = Não pode sondar. A atualização da janela pode fazer com que ela funcione.
You need to login for this function to work. = Você precisa fazer o login para esta função funcionar.

#About Dialog
An Easier EDA Experience = Uma experiência EDA mais fácil
Version = Versão
BuiltDate = BuiltDate

#Auto Router Dialog
Auto Router Config = Auto Router Config
General Options = Opções Gerais
All Layers = Todas camadas
Configure = Configurar
Sorry, your web browser does not support this feature. Please run a modern browser. = Desculpe, o seu navegador não suporta este recurso. Por favor, execute em um navegador moderno.
Please make sure all objects with net are inside the board outline! = Por favor garanta que todos objetos com net estejam dentro dos contornos da placa.
Cannot start again before previous activity is stopped = Não é possível iniciar novamente antes que a atividade anterior seja interrompida
Please select a net = Por favor, selecione uma net
TrackWidth cannot be empty = LarguraDaTrilha não pode ficar vazio
Clearance cannot be empty = Afastamento não pode ficar vazio
Router is time out. = O roteador esgotou o tempo limite.
Server is busy, please try again later. = O servidor está ocupado, por favor, tente novamente mais tarde.
Due to the limitation of {0}router server{1} resources, multiple routers executing concurrently are not supported, please try again later or do it manually :-) = Devido à limitação dos recursos do {0} servidor de roteadores {1}, vários roteadores em execução concorrente não são suportados, tente novamente mais tarde ou faça-o manualmente :-)
Track Width is invalid = Largura da trilha é inválido
General Clearance is invalid = O espaço geral é inválida
SMD Clearance is invalid = Espaço SMD é inválido
Diameter is invalid = O diâmetro é inválido
Drill Diameter is invalid = O diâmetro da broca é inválido
Track width cannot be less than Design Rule Checking (DRC) setting value. = Largura da trilha não pode ser menor que o valor definido pela Regra de Checagem de Design (DRC).
General Clearance cannot be less than Design Rule Checking (DRC) setting value. = Afastamento Geral não pode ser menor que o valor definido pela Regra de Checagem de Design (DRC).
SMD Clearance cannot be less than Design Rule Checking (DRC) setting value. = Afastamento SMD não pode ser menor que o valor definido pela Regra de Checagem de Design (DRC).
Hole size cannot be less than Design Rule Checking (DRC) setting value. = Tamanho do furo não pode ser menor que o valor definido pela Regra de Checagem de Design (DRC).
Design Rule's via diameter must be larger than via drill diameter = Diametro da via definido pelas Regras de Design deve ser maior do que o diâmetro do furo da via.
Clearance cannot be less than Design Rule Checking (DRC) setting value. = Afastamento não pode ser menor que o valor definido pela Regra de Checagem de Design (DRC).
Not a valid PCB, please check it again = Não é um PCB válido, por favor, verifique novamente
Previous connection must be closed = Conexão anterior deve estar fechada
Network error. Please try again. = Erro de rede. Por favor, tente novamente.
Router error. = Erro do roteador.
Invalid PCB. = PCB inválido.
General Clearance = Espaço Geral
SMD Clearance = Espaço SMD
#Ripup Nets
Skip Routed Nets = Ignorar redes roteadas
Remove Existing Tracks = Remover faixas existentes
Real-time Display =
Router Layers = Camadas de Roteador
Via = Via
Special = Especial
Special Nets = Net Especiais
Skip Nets = Pular Nets
Router Server = Servidor Router
Local = Local
Cloud = Nuvem
Available = Disponível
Unavailable = Indisponível
Checking = Verificação
Install Local Auto Router =
Checking local auto router server... = Verificando o servidor do roteador automático local…
Stop Router = Parar Roteador
Auto Router is running... = Auto Routeamento está rodando…

#Left Siderbar
EELib = EELib
Basic = Básico
Extend = Estender
Design Manager = Gerente de Design
Library = Biblioteca
Spice Library = Biblioteca Spice
Shared = Compartilhado
LCSC = LCSC
LCSC Parts = Partes LCSC
Supply Flag = Bandeiras de Alimentação
US =
EU/IEC =
US Style = Padrão dos EUA
Resistor = Resistor
Capacitor = Capacitor
Inductor = Indutor
Switch/Key = Chave
EU/IEC Style = Padraõ EU / IEC
CN =
Connector = Conector
Switch/Relay = Interruptor / Relé
JLCPCB = JLCPCB
Recycle Bin = Lixeira

# Protractor
Font Height = Altura da Fonte
Precision = Precisão
Protractor = Transferidor

#attr-pcbtext-line-width
Only default font family supports to change font width. =
Font is missing! You can confirm the dialog and use default font instead or cancel the dialog then upload your font and do it again. = Está faltando a fonte! Você pode confirmar a caixa de diálogo e usar a fonte padrão ou cancelar a caixa de diálogo e, em seguida, carregar sua fonte e fazê-lo novamente.

#Common
Owner = Proprietário
License = Licença
Part Pins = Pinos de Peça
Net Pins = Pinos da Net
Net Ratlines =
Add Parameter = Adicionar Parâmetro
Histories record = Registro de Histórias
Create Team = Criar equipe
Can't find this footprint on the server, please re-associate it. = Não foi possível encontrar este footprint no servidor. Por favor, reassocie-o.
The footprint name associated with the component and the footprint name on the server are inconsistent, please re-associate it. = O nome do footprint associado ao componente e o nome do footprint no servidor são inconsistentes. Por favor, reassocie-o.
The symbol pin number(s) of the component does not match the associated footprint pad number(s), please modify the symbol pin number(s) or re-associate the footprint =
No footprint, please associate the footprint first. = Sem footprint. Por favor, associe o footprint antes.
Can't find the package = Não é possível encontrar o pacote
The path is for the project URL identify, it is unique (the identity of the project owned by the user cannot be the same) = O caminho é para a identificação do URL do projeto, é único (a identidade do projeto pertencente ao usuário não pode ser a mesma)
It's with a letter or a number and can contain only numbers, letters, line-through, underscores, and points. It cannot be modified after saving. = É com uma letra ou um número e pode conter apenas números, letras, linhas, sublinhados e pontos. Não pode ser modificado depois de salvar.
Updating document to new format, please wait......After finishing please save your document with Ctrl + S. = Atualizando documento para novo formato, por favor aguarde...  Depois de terminar, por favor salve seu documento com Ctrl + S.
Open at current project? = Abrir no projeto atual?
Please select a history to recover. = Por favor, selecione um histórico para recuperar.
Be careful! When you click the "Recover" button, this sheet will be overwritten! = Seja cuidadoso! Quando você clica no botão "Recuperar", esta folha será substituída!
Recover = Recuperar
There is no PCB under this project, would you like to create one? = Não há PCB sob este projeto, você gostaria de criar um?
Please make sure that the chose Altium Designer files are saved as ASCII files. = Por favor, certifique-se de que os arquivos escolhidos pelo Altium Designer são salvos como arquivos ASCII.
Export to Altium function is currently in beta: =
1. Please be sure to read the notice before exporting: =
Export Altium notice and disclaimer =
2. Please be sure to check again after export! =
I have read and agree = Eu li e concordo
Export to Altium = Exportar para Altium
Please make sure that the chose Eagle files are saved in Eagle v6.0 and above. = Por favor, certifique-se de que os arquivos Eagle escolhidos estão salvos no Eagle v6.0 e superiores.
Please make sure that the Kicad files were compressed as the .zip file. = Por favor, certifique-se de que os arquivos do Kicad foram compactados como arquivos .zip.
Open Altium Designer file = Abra o arquivo Altium Designer
The more information please refer at : =
Please use Gerber file instead of exporting Altium if you are going to do PCB manufacturing. All PCB factories support the Gerber file. Is it ok to Generate the Gerber file? =
Yes, Generate Gerber = Sim, Gerar Gerber
No, Export Altium = Não, Exportar Altium
Open Eagle file = Arquivo Open Eagle
Open Kicad file = Abra o arquivo Kicad
Select file(s) = Selecione arquivo(s)
Append to current project? = Anexar ao projeto atual?
Append = Anexar
Open as new project = Abrir como novo projeto
Tip: Press {0}SPACE{1} or {2}R{3} to rotate the placing object or selected object. = Dica: Pressione {0} ESPAÇO {1} ou {2} R {3} para girar o objeto de colocação ou o objeto selecionado.
Hotkeys Setting = Configuração de Teclas de Atalho
I know. Don't show this again. = Eu sei. Não mostre isso novamente.
Manufacturer Part Number can not be less than 2 characters. = O número da peça do fabricante não pode ter menos de 2 caracteres.
This prefix was changed to non-subpart format. = Este prefixo foi alterado para o formato não-subparte.
Save as New Project = Salvar como novo projeto
Save to Existing Project = Salvar no projeto existente
Sheet Setting = Configuração de Folha
Sheet Size = Tamanho da folha
Pre = Pre
pre = pre
Invalid Data = Dados inválidos
Others = Outros
You are not authorized to share this project. = Você não está autorizado a compartilhar este projeto.
This project is private: if you continue sharing it will be made public. = Este projeto é privado: se você continuar compartilhando, será tornado público.
Modify file info = Modificar informações do arquivo
Please input search keyword = Por favor insira a palavra-chave de pesquisa
Sort Projects by = Ordenar por
Date Created = Data de criação
Date Modified = Data de modificação
Title = Título
Ascending = Ascendente
Descending = Descendente
Pin to Top = Pino para o Topo
Unpin from Top = Soltar Pino do Topo
Collapse / Expand = Expandir / Recolher
Expand = Expandir
Collapse = Colapso
Expand All = Expandir tudo
Collapse All = Recolher tudo
Your file hasn't been saved, do you want to save it? = Seu arquivo não foi salvo, você quer salvá-lo?
Don't Save = Não salvar
Library Owner: = Proprietário da biblioteca:
verifyPkg.Value = verifyPkg.Value
State = Estado
Please select! = Por favor, selecione!
Route = Rota
Import successfully: = Importar com sucesso:
Import failed: = Falha na importação:
The title length must be between 2~128 characters. = O comprimento do título deve ser de 2~28 caracteres.
Path only contain 'a-z、A-Z、- 、 _ 、0-9'! = O caminho contém apenas 'a-z' A-Z '- 、 _ 、 0-9'!
Path must begin as 'a-z、A-Z、0-9'! = O caminho deve começar como 'a-z' A-Z '0-9'!
The path length must be between 4~128 characters! = O comprimento do caminho deve estar entre 4 ~ 128 caracteres!
The title length must be between 2~256 characters! = O tamanho do título deve estar entre 2 e 256 caracteres!
The title cannot be less than 3 characters! = O título não pode ser menor que 3 caractéres!
Do you want to delete this file? = Você quer apagar este arquivo?
Add sub part success = Sub-parte adicionado com sucesso
Please input name and prefix! = Por favor insira o nome e o prefixo!
Board outlines are not closed = Os contornos da placa não estão fechados
Import Altium file fail, the file needs to be an ASCII file encoded in UTF-8. =
The Pins "{0}" are not snapped on the grid point! This part maybe will cause some errors in the schematic. = Os pinos "{0}" não são encaixados no ponto da grade! Esta parte talvez cause alguns erros no esquema.
Check Pin = Verifique o Pin
Failed to read {0} = Falha ao ler {0}
{0} is invalid = {0} é inválido
{0} not found = {0} não encontrado
Failed to execute script: = Falha ao executar script:
One or more js files not found = Um ou mais arquivos js não encontrados
Only ONE {0} file is required = Apenas UM {0} arquivo é necessário
Extension ID is required = O ID de extensão é obrigatório
Extension ID is invalid = O ID da extensão é inválido
Extension ID is duplicated = O ID da extensão é duplicado
No Result! = Nenhum resultado!
Load Error = Erro de carga
loading = carregamento
Failed to load spice data = Falha ao carregar dados do Spice
Netlist = Netlist
Tags = Tags
Pin Information: = Informação de Pin:
Format incorrect, please check for the extra spaces or commas! = Formato incorreto. Por favor, verifique por espaços extras ou vírgulas.
Round Radius = Raio Redondo
Keyword: = Palavra chave:
Image = Imagem
Image copied. = Imagem copiada.
Copy failed. = Falha ao copiar.
Copy success. =
Image Property = Atributo de Imagem
Locked = Bloqueado
Unlock All = Desbloquear todos
Unlock = Desbloquear
Lock = Bloquear
Please input pin name and pin number! = Por favor insira o nome e o número do pino!
Left-Hand Panel = Painel Canhoto
Right-Hand Panel = Painel Destro
Update All = Atualizar Todos
The pin number(s) can't find the same pad number(s) = O(s) número(s) dos pinos não podem encontrar o(s) mesmo(s) número(s) do(s) bloco(s)
Designator = Designador
Replace = Substituir
Update failed = Falha de atualização
Successfully updated = Atualizado com sucesso
Update failed! = Atualização falhou!
Successfully updated! = Atualizado com sucesso!
Successfully updated {0} component(s)! =
Change = Trocar
Check Footprints = Verificar Footprints
Network Error! = Erro de rede!
Find Similar Objects = Encontre Objetos Similares
Current Sheet = Folha atual
All Sheets = Todas as folhas
Kind = Tipo
Range = Faixa
Net Label/Net Flag/Net Port/Voltage Probe = Rótulo de Rede / Bandeira de Rede / Net Port / Sonda de Tensão
Bezier/Freehand Draw = Bézier / Desenho a mão livre
Arc/Pie = Arco / Pie
Objects Properties = Atributos de Objetos
Any = Qualquer
Same = Mesmo
Different = Diferente
Circular = Circular
Expose Copper = Mostrar Cobre
"{0}" font is missing. Please add the font to the font family list. = A fonte "{0}" não existe. Por favor, adcione a fonte na lista de fontes.
Place Component = Coloque o componente
Delete Segment = Excluir segmento
Angle = Ângulo
Board Thickness = Espessura da placa
Layer Distance = Distância de Camada
Silk Screen = Tela Silk
Surface Finish Color = Cor de Acabamento da Superfície
Colors = Cores
Board Color = Cor da placa
Board Side = Lado da placa
Silk Screen = Tela Silk
Silk Screen Color = Cor da tela de seda
Display = Display

# Array and Clone
Distribute Array = Distribuir Matriz
Array Type = Tipo de Matriz
Matrix Array = Matriz Matriz
Circular Array = Array Circular
Item Rotation = Rotação do Item
Location = Localização
Items per Column = Itens por Coluna
Items per Row = Itens por linha
# Column Spacing
# Row Spacing
Spacing(Degrees) = Espaçamento (Graus)
Start Degree = Grau inicial
Rotate Item to Match = Rodar Item para Corresponder
Clockwise = Sentido horário
Anti-Clockwise = Anti-horário
Distribute by = Distribuir por
Column = Coluna
Row = Linha
Array Clone =
Number of Rows = Número de Linhas
Number of Columns = Número de Colunas
Number of Copies = Número de Cópias
Distribute Range(Degrees) =

# Theme color dialog
BusEntry = BusEntry
Foreground = Primeiro plano
Common Used = Mais Usado
Original Theme = Tema Original
Theme Setting = Definição de Tema
Change the theme colors of your design = Mude as cores do tema do seu design
White on Black = Branco em preto
Black on White = Preto em branco
Custom Theme = Tema Personalizado
Color Setting = Configuração de cor
Apply Setting = Aplicar Configuração
Theme Setting... = Definição de Tema…
Bus Entry = Entrada de Bus
Foreground = Primeiro plano
Symbol Graphics = Gráficos de Símbolos
Common Used = Mais Usado
Draw = Desenho
Sheet = Folha
The original theme only works for placing the new symbols. = O tema original só funciona para colocar os novos símbolos.
Selection Highlight = Destaque de seleção
Net Label / Port = Rótulo / Porta de Rede

My Theme = Meu tema
My Theme Settings = Minhas configurações de tema
Apply 'Custom Theme' On =
Creating New Schematic = Criando Novo Esquema
Opening Existed Schematic = Abrindo o esquema existente
Please fill in all parameters! = Por favor, preencha todos os parâmetros!
Convert to Board Cutout =
Prefix Position = Posição do Prefixo
Name Position = Posição do Nome
Center = Center
Top = Topo
Bottom = Fundo
Left = Esquerda
Right = Direita
Does not support multiple objects to convert to Board Cutout at the same time =
Does not support multiple objects to convert to pad at the same time =
Convert to Board Cutout =
Convert to Pad =
Convert to Component Shape = Converter para Forma de Componente
Combine to Continuous Track = Combinar Traço Contínuo
Convert to Solid Region = Converter para Região Sólida
Substrate = Substrato
3D View = Visualização 3D
2D View = Visualização 2D
Pin Color = Cor do Pino
Name Color = Nome da Cor
Number Color = Cor do Número
Dot = Ponto

[theme]
Sheet = Folha
[/theme]


#history dialog
[history-dlg]
Number = Número
Editor = Editor
[/history-dlg]
View File History = Visualizar Histórico do Arquivo
Save Time = Economize Tempo

Invalid Format = Formato inválido

#Dialog Teardrop
Round Pad / Via = Pad Redondo / Via
Rectangle / Oval / Polygon Pad = Retângulo / Oval / Polígono Pad
Applying Teardrops = Aplicando Teardrops
Removing Teardrops =
Waiting = Esperando
Progressing... = Processando...

No schematic in the project! = Nenhum esquema no projeto!

Move Forward = Mover para frente
Move Backward = Mover para trás

#Dialog Panelize
V-CUT =
Stamp Hole =
No Panelize =
Border and Marking = Fronteira e Marcação
Create Border = Criar Borda
Border Height = Altura da Borda
Border Position = Posição da Fronteira
Create Positioning Holes = Criar furos de posicionamento
Create Fiducial Marks = Criar marcas fiduciárias
Top and Bottom = Superior e Inferior
Left and Right = Esquerda e Direita
Stamp Hole Group - Column =
Stamp Hole Group - Row =
The number of rows and columns cannot be set to 1 simultaneously = O número de linhas e colunas não pode ser definido como 1 simultaneamente

#edit path point
[editPathPoints-dlg]
Arc(R) = Arco(R)
Type = Type
Action = Ação
add before = adicionar antes
add after = adicione depois
delete = delete
[/editPathPoints-dlg]

#edit polygon point
[editPolygonPoints-dlg]
Action = Ação
add before = adicionar antes
add after = adicione depois
delete = delete
[/editPolygonPoints-dlg]
You have unconfirmed edit! = Você tem uma edição não confirmada!
Invalid edit! = Edição inválida!

#Dialog PCB Information
PCB Information... = Informação do PCB...
Signal Layers = Camadas de Sinal
None Signal Layers = Nenhum Camada Signal
Pads = Pads
Surface Pads = Pads de Superfície
Plated Through-hole Pads = Pads inseridos em orifícios
None Plated Through-hole Pads = Nenhum Pad inserido em orifício
Holes = Furos
Vias = Vias
Length of Tracks = Comprimento de Trilhas
Copper Areas = Áreas de cobre

#Differential Pair Routing
Differential Pair Routing = Roteamento Diferencial de Pares
Differential Pair Rule Setting = Ajuste da Regra de Par Diferencial
Please input track width = Por favor, insira a largura da faixa
Please input clearance = Por favor introduza espaço
Routing Rules = Regras de Roteamento

#Route Length Tuning
Track Length Tuning... = Ajuste do Comprimento da Trilha…
Tracks with different net or non-track found in current targets. = Faixas com rede ou não rastreio diferentes encontradas nos destinos atuais.
Please select the signal tracks to be tuning. = Por favor, selecione as faixas de sinal para sintonizar.
The total length exceeds the Design Rule Checking (DRC) constraint, continue ? = O comprimento total excede a restrição das Regras de Checkagem de Design (DRC). Continuar?
45° Angle = Ângulo de 45 °
90° Angle = Ângulo de 90 °
DRC Track Length : = Comprimento da faixa DRC:
Current Length : = Comprimento Atual:
Additional Length : = Comprimento Adicional:
Target Length: = Comprimento Alvo:
Current Length: = Comprimento Atual:

can not connect to the server = não pode conectar-se ao servidor

#Dialog Copper Area Manager
Copper Area Manager... = Gerenciamento da Área de Cobre…
Copper Area Manager = Gerenciamento da Área de Cobre
Order = Ordem
Name = Nome
Layer = Camada
Color = Cor
Net = Net
Move Up = Mover para Cima
Move Down = Mover para baixo
Apply = Aplicar
Cancel = Cancelar
Copper Area do not allow self-intersection! = Área de Cobre não permite auto-interseção!
No copper area! = Nenhuma área de cobre!
#Dialog report error
Datasheet = Datasheet
Verification = Verificação
Symbol = Símbolo
Pad Number = Número do Pad
Pad Size = Tamanho do Pad
Remark = Comentário
Correct = Correto
Incorrect = Incorreto
Submit = Submeter
Tip = Dica
Please select one component = Por favor selecione um componente
Location X = Localização X
Location Y = Localização Y
Your current browser version may not support some features. Please use the latest version of Chrome or Firefox, or try the desktop client. = A versão atual do seu navegador pode não oferecer suporte a alguns recursos. Use a versão mais recente do Chrome ou Firefox ou experimente o cliente.
EasyEDA Client = Cliente EasyEDA
LCEDA Client = Cliente LCEDA
Chrome = Chrome
FireFox = FireFox
New Version = Nova versão
Switch Version = Versão do Comutador
Members = Membro
Update Time = Atualizar hora
Editor = Editor
Current Version: = Versão Atual
Select a version to switch = Selecionar uma versão para mudar
3D Model = Modelo 3D
Board Side = Lado da placa
Display = Display
Copper = Cobre
Create New Version = Criar Nova Versão
Create new version success! = Nova versão criada com sucesso!
Version Management = Gerenciamento de Versão
Switch success! = Mudado com sucesso!
Please close current version's documents first! = Por favor, feche a versão atual do documento primeiro!
Creator = Criador
Create Time = Data de Criação
Fail to connect to server! Please check your internet connection status and try again! = Falha ao conectar no servidor! Por favor, verifique sua conexão com a internet e tente novamente!
Spice Number = Número Spice
Create = Criar
3D Outline = Delineado 3D
Cannot create the slot hole via the board outline, please use the following methods: =
Use the solid region and set its type as Board Cutout =
Select a Track/Arc, right-click to use the "Convert to Board Cutout" =
Select all the closed Tracks/Arcs, right-click to use the "Convert to Board Cutout" =
The more information please refer at = Para mais informações acesse
Save "{0}" success! = Sucesso ao salvar "{0}"!
Save "{0}" failed! = Falha ao salvar "{0}"!
Invalid Size = Tamanho Inválido
Processing = Processando
Invalid Size = Tamanho Inválido
NetFlag GND =
NetFlag VCC =
NetFlag +5v =
No Useful Data! =
SVG Preview =
Prefix contains not supported charater(s) ! = Prefixo contém caractere(s) não suportado(s)!
Name contains not supported charater(s) ! = Nome contém caractere(s) não suportado(s)!
Create Grid Path =
Please Input Name = Favor Inserir Nome
Building Copper Area = Contruindo área de cobre
Processing = Processando
Opening File = Abrindo Arquivo
Update from Library = Atualizar da Biblioteca
Update Footprint = Atualizar Footprint
Find footprint(s) have been updated, do you want to update? =
3D File: = Arquivo 3D:
Model List = Lista de Modelo
Are you sure merge net {0} and net {1}? = Tem certeza que quer unir rede {0} e rede {1}?
Display Footprint = Mostrar Footprint
Display Footprint Name While Placing Component = Mostrar Nome do Footprint ao Colocar Componentes
Annotate Prefix Automatically After Placing Component = Atribuir Prefixo Automaticamente após Colocar Componentes
Program Error, Please Contact Technical Support! = Erro de Programa, Por favor, Entre em Contato com o Suporte!
Search Engine = Motor de Busca
Keyword to Filter = Palavra-Chave para Filtrar
Normal Mode = Modo Normal
Expand Mode = Modo Expandido
3D Model Manager = Gerenciador de Modelos 3D
3D Model Preview = Pré-visualização do Modelo 3D
3D Model = Modelo 3D
3DModel = Modelo3D
Document = Documento

[pcblayer]
3DModel = Modelo3D
Document = Documento
[/pcblayer]

Adjustment = Ajuste
View Larger Image = Ver imagem maior
Previous = Anterior
Previous Image = Imagem Anterior
Next Image = Próxima Imagem
Notice: For reference only, please refer to the real product =
It's under designing, please wait. =
The width of track/arc/circle cannot be less than 0.1mil! = A largura da trilha/arco/círculo não pode ser menor de que 0.1mil!
Clone success ! = Clonado com sucesso !
Footprint Naming Reference =
3D Model Manager = Gerenciador de Modelo 3D
Will jump to the Lichuang open source hardware platform (OSHWHub.com) to improve the information and share. Whether to continue? =
Will jump to the EasyEDA open source hardware platform (OSHWLab.com) to improve the information and share. Whether to continue? =
The project content page will open. After adding a description and setting the project to public, you can click the share button to get the share link. =
This project is not public, can not view homepage! = Esse projeto não é público, não pode acessar a homepage!

[grid]
None = Nenhum
[/grid]

#lib verify and mounted
This component is verified = Este componente é verificado
This component is unmounted = Este componente é desmontado

#find component
Find Next = Encontrar próximo
Object not found = Objeto não encontrado

#offset Elements
Offset X = Offset X
Offset Y = Offset Y
Offset = Offseet
Absolute Offset = Offset Absoluto
Relative Offset = Offset Relativo
Absolute Offset... = Offset Absoluto...
Relative Offset... = Offset Relativo...
Reference Point X = Ponto de Referência X
Reference Point Y = Ponto de Referência Y

# Inner Plane layer
Rebuild Plane = Reconstruir Plano
PlaneZone Properties =
Change to a plane layer is not allowed during track routing. =
#pcblib rect
Fill = Preencher
Fill Type = Tipo de Preenchimento
[PlaneZone]
Solid = Sólido
[/PlaneZone]

Solid Region do not allow self-intersection! =

The prefix or name or text too far away from the footprint, if you don't want it to show up please make it hidden. =
The prefixes are not allowed to repeat! =
Save failed! The origin of the canvas is not in the graphics! Whether to set the origin automatically? =
The origin of the canvas has been set in the graphics now, you can save again. =
Backup Project = Fazer Backup do Projeto
Open Project Directory =

{0} items updated = {0} itens atualizados

The current file {0} has an updated version. Do you want to overwrite it? If you want to open the latest version, please close the current file and reopen it. = O arquivo atual {0} possui uma versão atualizada. Deseja sobrescrevê-lo? Se deseja abrir a última versão, por favor feche o arquivo atual e abra-o novamente.
Yes, Overwrite It = Sim, Sobrescrever
No, Keep It = Não, Manter

Download Client = Baixar Cliente

Search tutorial、open source projects etc. = Procure por tutoriais、projetos de código aberto etc.

Go to LCSC and search for = Ir para LCSC e pesquisar por
Go to LCSC = Ir para LCSC

Hide Ratline Layer and Keep the Component Prefix When Paste Objects = Ocultar Camada Ratline e Manter o Prefixo dos Componentes ao Colar Objetos

ALL.layer = Todas
Copper.layer = Cobreadas
Non-Copper.layer = Não-Cobreadas
Other.layer = Outros

Please enter at least 2 characters! = Por favor, digite ao menos 2 caracteres!
View Datasheet = Ver Datasheet
View Datasheet... = Ver Datasheet...

The corresponding package or network could not be found in the currently open PCB document =
delete fail =

[crashRecovery]
Libraries = Bibliotecas
[/crashRecovery]
Canvas origin anomaly! =

Component's Name = Nome do Componente
Component's Prefix = Prefixo do Componente
Component's Footprint = Footprint do Componente

[findlib]
Clear = Limpar
Apply Filters = Aplicar filtros
Result = Resultado
Place = Colocar
Prev = Anterior
Next = Próximo
Total {count} Count =
About = Sobre
Items = Itens
[/findlib]

Object = Objeto
Layers and Objects = Camadas e Objetos
All = Tudo

Add custom = Adicionar Personalizado

Connections = Conexões
Attempted: = Tentativas:
Completed: = Completos:
Failed: = Falhas:
Total Vias: = Total de Vias:

Please confirm moving option = Por favorm confirme a opção de mover
Only this pad =
For this component = Para esse componente
View Owner = Ver Dono
View Detail = Ver Detalhe


# place batch vias
Place Vias = Colocar Vias
Placing Vias = Colocando Vias
Removing Vias = Removendo Vias
Batch Vias for Copper =
Add/Remove Vias = Adicionar/Remover Vias
Diameter = Diâmetro
Drill Diameter = Diâmetro de Perfuração
Column Spacing = Espaçamento da Coluna
Row Spacing = Espaçamento entre Linhas
Multiple vias have been placed, do you want to rebuild the copper area? = Múltiplas vias foram colocadas, você quer reconstruir a área de cobre?
Remove vias finish, do you want to rebuild the copper area? = Remoção de vias terminada. Deseja reconstruir a área de cobre?
The width of track/arc/circle cannot be less than 0.051mm/2mil/0.002inch! = A largura da trilha/arco/círculo não pode ser menor que 0.051mm/2mil/0.002inch!
Save fail! Please try again! = Falha ao salvar! Por favor, tente novamente!
Please select a copper outline =
Can't find copper area at other layers, please add the copper area with the same net at other layer first. =

Add favorite success! = Sucesso ao adicionar aos favoritos!
Remove favorite success! = Sucessor ao remover dos favoritos!
Remove favorite failed! = Falha ao remover dos favoritos!
Whether if remove favorite? =
Split by ';' for multi tags = Separar por ';' para múltiplas tags

This size is the determined size! = O tamanho é o tamanho determinado!
The associated pad has been locked =
Split by space or , for multi tags = Separar por espaço ou , para múltiplas tags

Rotation X = Rotação em X
Rotation Y = Rotação em Y
Rotation Z = Rotação em Z

Some fields are filled invalid data = Alguns campos estão preenchidos com dados inválidos
start time should be earlier than stop time = tempo de início deve ser antes do tempo de término
Number of points should be less than 100 in octave variation = Número de pontos deve ser menor do que 100 na variação da oitava
Start frequency should be less than stop frequency. The suffix meg stands for Mega,m stands for milli = Frequência de início deve ser menor que a frequência de parada. O sufixo meg significa Mega e o m significa mili
Get historical records fail! =
This 3D model didn't create the outlines successfully, please import it again or contact with us. =
There is No Tag! = Não tem Tag!
Assign successful! =
Found footprint's pad number doesn't match the schematic component's pin number, please correct the pad number and try again! =
Update Property = Atualizar Atributo
Please fill in at least 5 words. = Por favor, preencha pelo menos 5 palavras.
Mouse hovering over the track to highlight the entire network =
Net Highlighting While Cursor Hover the Track = Iluminar Net ao passar o Cursor sobre a Trilha
When circle set as "Yes", the Pin length must be more than 6 =
Hi, I found a problem of your library, this library seems incorrect.\ntitle:{title}\nType:{type}\nlink:{link}\n{content}\nThank you! =

Logout fail! Please try again! = Falha ao desconectar! Por favor, tente novamente!
Logout success! We look forward you to use LCEDA again! = Sucesso ao desconectar! Esperamos que você use LCEDA novamente!
Logout success! We look forward you to use EasyEDA again! = Sucesso ao desconectar! Esperamos que você use EasyEDA novamente!
Click to Preview 3D = Clique para ver Preview 3D
[logoutDialog]
Logout = Desconectar
[/logoutDialog]

[findlibTag]
All = Tudo
[/findlibTag]

Export Pick and Place File = Exportar Arquivo de Pick and Place
Mirror the bottom component's X coordinate (JLCPCB doesn't need) =
Work Space = Espaço de Trabalho
Include panelized components' coordinates =
Personal Workspace = Espaço de Trabalho Pessoal
Work Space - {name} =
Work Space - Personal =
Cloning = Clonando

Project Owner =
Clone Project =
Homepage =
Apply for Education Edition =
Load Organization failed =
Joined =
Favorite = Favorito
This operation will unfavorite this project, do you want to continue? =
View Homepage =
Private Project =
3-7 days = 3-7 dias
Close Tab = Fechar aba
Close Other Tabs = Fechar outras abas
Close All Tabs = Fechar todas abas
Open in New Window = Abrir em uma nova janela
Cursor Snap to Component's Origin or Pad Center While Dragging Component = Fixar o Cursor à Origem do Componente ou ao Centro da Ilha enquanto estiver arrastando o Componente
Undefined =
Input =
Model Unit =
File Unit =
This part contains subparts, please make sure you have checked other subparts before reporting error, do you want to continue? =

[saveAs]
Power = Poder
[/saveAs]

Assign LCSC Part# =
Unexpected error while converting. Perhaps unsupported file type or program bug. =
Found duplicated component IDs, please click "OK" to re-assign component ID automatically, and then save the document and try again. =

#electromagneticSimulation
Electromagnetic Simulation... = Simulação Eletromagnética...
You will upload Gerber to SuperEM for electromagnetic simulation (only upload Gerber, not including account data), do you want to continue? =
SuperEM is a 3-D full-wave electromagnetic simulation and design platform for high-speed PCB circuits and antennas, which is developed by Faraday Dynamics, Ltd. =
Visit the SuperEM =
SuperEM User Guide =
Upload Gerber to SuperEM successfully, please click "OK" buttun to continue =

Format = Formato
View = Visualizar
Design = Design
Simulation = Simulação
Advanced = Avançado
Fabrication = Fabricação
Check DRC = Checar DRC
Simulation Setting = Configuração de Simulação
BOM = BOM
PCB Fabrication File(Gerber) = Arquivo de Fabricação de PCB(Gerber)
Pick and Place File = Escolher e Colocar Arquivo
Parts Order = Pedido de Partes
PCB Order = Pedido de PCB
SIM = SIM
STD = STD
WaveForm = Forma de Onda

Place Module = Colocar Módulo
Please enter identification letters: =
Only support English letters, up to 5. =

Exist doesn't annotate prefix component(s) in the module, please edit and annotate the unique prefix(s) for component(s) first. =
Opening =

Also update track's net (Only applies to circumstance under which prefix/netlabel changes and no component/wire is added or removed) =

# desktop client error feedback
Cannot open online documents on Project Offline mode. =

Please select a project = Por favor, selecione um projeto
Opened Projects = Projetos Abertos
Open Project = Abrir Projeto
Close Project = Fechar Projeto
Open All Projects = Abrir Todos os Projetos
Close All Projects = Fechar Todos os Projetos
Select Owner =
Select Folder =
Select Owner or Folder =
Select Project =
Folder =
New Folder =
New Sub Folder =
Delete Folder =
Move Project =
Move Folder =
# Rename Folder =
Please input the folder name =
Invalid folder name =
Are you sure to delete this folder? =
Create new folder successfully =
Failed to create new folder =
Delete folder successfully =
Failed to delete folder =
Rename folder successfully =
Failed to rename folder =
Move folder successfully =
Failed to move folder =
Move project successfully =
Failed to move project =
The folder depth must not exceed {0} levels =
Failed to add project to folder =

Doesn't support JLCPCB SMT Service =
{0} for JLCPCB SMT Service =

Reset failed! There are duplicate component prefixes in the current schematic: =
Reset failed! There are duplicate component prefixes in the current PCB: =
Please modify the component prefixes first to ensure that the component prefix is unique. =

LCEDA(Standard) - A Simple and Powerful Electronic Circuit Design Tool =
EasyEDA(Standard) - A Simple and Powerful Electronic Circuit Design Tool =

#Dialog for Package Custom Data
Please input the data title =
Data title duplicated =
Cannot be more than {0} characters! =
Only latin alphabets, digits, underscore(_) and hyphen(-) are allowed. =
Invalid value of item {0} =
Update DFM =
Custom DFM Data =
Saved custom data successfully! =
Save custom data failed! =
Will replace the graphics and custom data of current document, after imported please adjust the 3D model. Continue or not? =
Open footprint "Custom Data" dialog =

# Create lead shape
Create Lead Shape =
Base on Pad Center =
Base on Canvas Origin =
Lead shape =
Footprint Type =
From pad shape =
Lead length =
Lead width =
Lead diameter =
Scaling ratio =
Leads creating direction =
Auto = Auto
Horizontal =
Vertical =
Canvas origin to lead edge =
Canvas origin to body edge =
Lead soldering length =
Lead soldering part diameter =
Component shape object doesn't overlap lead shape object, please check carefully. =
The solder mask expansion of pads ({0},{1}) has a small clearance(less than 0.08mm), it will cause the soldering too short, please modify. =
The paste mask expansion or custom paste mask layer objects of pads ({0},{1}) has a small clearance(less than 0.15mm), it will cause the stencil to create fail, please modify. =
System footprint must have pad number 1 or A1, please modify the pad number. =
System footprint doesn't allow two or more pad numbers are 1 or A1, please modify the pad number. =
Document layer has circle object, but jlcPara's polarity is 0, please check the Custom Data. =
There are exist repeat pad numbers: {padNumber}, please check, if it is correct please ignore this. =
Can't find the circle at the component marking layer, or this circle doesn't at the same quadrant with the 1st pad, please check whether it is correct. =

ROUND =
RECTANGLE =
OCTAGONAL =
Upper left =
Lower left =
Center of Pads =
First Pin =
Package Name =
Pins Number =
Rows Of Pin =
Columns Of Pin =
Polarity =
Pad Shape =
Body Diameter =
Lead Span =
Lead Vertical Span =
Body Length =
Body Height =
Pin Diameter =
Pin Length =
Pin Height =
Pin Solid Width =
Pin Solid Height =
Pin Spacing =
Pin Horizontal Spacing =
Pin Vertical Spacing =
ThermalPad =
Pad Expansion =
Custom PasteMask =
Fabrication Tolerance =
Placement Tolerance =
FirstPin Position =
Package Origin =
Expansion Size =
Corner =
Angle = Ângulo
Fillet =
Chamfer =
Update Preview =
Number of pins (left and right) =
Number of pins (up and down) =
Reference Use Cases =
Package Type =
Capacitance = Capacitância
Resistance = Resistência
Bidirectional Diode =
Inductance = Indutância
Crystal Oscillator =
Diode = Diodo
LED = LED
Fuse = Fusível
Entity height =
Lead Overhang =
Lead Thickness =
Unknown mistake =
Has ThermalVias =
Polar Capacitance =

Create Component Marking =
Create component marking successfully! =
No elements on component shape layer! =
No elements on lead shape layer! =
No pad of number 1 or A1, please modify the pad number. =
Save failed! Component marking circle is at the axis. Do you want to recreate the component marking? =
If autoroute fail, you can export the autoroute file(DSN) to third-party autorouter tool(Such as: Konekt Electra, Eremex TopoR etc.), and export the session file(SES) after finished autoroute, and then import to PCB. =
Auto route failed! Found abnormal pad(s) data, please modify the pad width and height: =
Select Properties =
Combine the same parts' prefixes in one row =
Please check at least one item! =
Pins =
Check component latest version when open schematic =
Only show updated components =
Note: When a PCB is Import Changes, the PCB is updated according to the footprint version to which the schematic is bound. =
Doesn't support to import the binary format DXF, please import the ASCII format DXF. =

Find System Similar Footprint =
Found similar footprints at system library, it is recommended to use them first. =
Copy Title =
Check system similar footprint =
Can't find the Similar Footprint =
Search failed! =
No package information! =
Find Parameters =
Find Results =

Bill of meterial(BOM) uploaded finish, please click "OK" to continue. = 
Bill of meterial(BOM) upload failed! = 

All pads =
All holes =
Single layer pads =
Multi-layer pads =
Same X pads =
Same Y pads =
Same Y and clearance pads =
Same X and clearance pads =
Same X and clearance pads' clearance =
Same Y and clearance pads' clearance =
Pad's hole diameter(max) =
Pad's hole diameter(min) =
Pad's hole diameter(aver) =

Try Pro Edition =

Generate Solid Region by Objects Outline =
Generate Polygon Pad by Objects Outline =
Select the objects that cannot be generated =

Please compress schematic and PCB as a zip file and then import it, if you only import the schematic you need to binding with the footprint manually. = 
Please compress schematic and PCB in ASCII format as a zip file and then import it, if you only import the schematic you need to binding with the footprint manually. = 
Import failed! The imported files were not ASCII format, please save the files as "Advanced Schematic ascii(*.SchDoc)" or"PCB ASCII File(*.PcbDoc)" at Altium Designer first, and then import. = 
The PCB text will use the editor new font family, the text maybe will appear a litte excursion. = 
Because of different file format and element, please check carefully after imported. = 
Please make sure the EAGLE file is saved in EAGLE v6.0 and higher version. = 
Please compress schematic and PCB as a zip file by KiCad5 and then import it, if you only import the schematic you need to binding with the footprint manually. = 
Please make sure the Protel file is exported as ASCII format file. = 
Please compress the schematic and corresponding symbols as a zip file and then import it. = 

Please save the files as "Advanced Schematic ascii(*.SchDoc)" or"PCB ASCII File(*.PcbDoc)" at Altium Designer first, and then import. = 
Tips = 
Exists incomplete connection = 
Found that the board has incomplete connection, please check the nets and ratlines = 
creator = 
You are not logged in or the login status is invalid, please login and try again. = 
Display Board Cutout = 